! ========== !
! Pronominer !
! ========== !

LEXICON Pronomen
	DemPron ;	!Demonstrative pronominer
	IntPron ;	!Interrogative pronominer
	PersPron ;	!Personlige pronominer
	DivPron ;	!Uegentlige pronominer
	ReflPron ;	!Refleksive og reciprokke pronominer
	IndefPron ;	!Indefinitte pronominer

LEXICON DemPron	!(demonstrative pronominer)
anna:av	DemPron1 ;
panna:pav	DemPron1 ;
qanna:qav	DemPron1 ;
inna:iv	DemPron1 ;
kanna:kan	DemPron1 ;
qanna:qam	DemPron1 ;
sanna:sam	DemPron1 ;
pinnga:pik	DemPron1 ;
innga:ik	DemPron1 ;
kinnga:kig	DemPron1 ;
manna:man	DemPron1 ;	!(massuma)
manna:man	DemPron3 ;	!Speciel (matuma)
una:uv	DemPron2 ;
TA+anna:taajav	DemPron1 ;
TA+panna:tappav	DemPron1 ;
TA+qanna:taqqav	DemPron1 ;
TA+inna:taajiv	DemPron1 ;
TA+kanna:takan	DemPron1 ;
TA+qanna:taqqam	DemPron1 ;
TA+sanna:tasam	DemPron1 ;
TA+pinnga:tappik	DemPron1 ;
TA+innga:taajik	DemPron1 ;
TA+kinnga:takkig	DemPron1 ;
TA+manna:taman	DemPron1 ;	!(tamassuma)
TA+manna:taman	DemPron3 ;	!Speciel (tamatuma)
TA+una:taav	DemPron1 ;
AA+anna:aajav	DemPron4 ;
AA+panna:aapav	DemPron4 ;	
AA+qanna:aaqav	DemPron4 ;
AA+inna:aajiv	DemPron4 ;
AA+kanna:aakan	DemPron4 ;
AA+qanna:aaqam	DemPron4 ;
AA+sanna:aasam	DemPron4 ;
AA+pinnga:aapik	DemPron4 ;
AA+innga:aajik	DemPron4 ;
AA+kinnga:aakig	DemPron4 ;
AA+manna:aaman	DemPron4 ;
AA+una:aaju	DemPron4 ;
AA+una:aa	DemPron4 ;
anna:av	DemAdv1 ;
panna:pav	DemAdv1 ;
qanna:qav	DemAdv1 ;
kanna:kan	DemAdv1 ;
qanna:qam	DemAdv1 ;
sanna:sam	DemAdv1 ;
pinnga:pik	DemAdv1 ;
innga:ik	DemAdv1 ;
kinnga:kig	DemAdv1 ;
TA+anna:taav	DemAdv1 ;
TA+panna:tappav	DemAdv1 ;
TA+qanna:taqqav	DemAdv1 ;
TA+kanna:takan	DemAdv1 ;
TA+qanna:taqqam	DemAdv1 ;
TA+sanna:tasam	DemAdv1 ;
TA+pinnga:tappik	DemAdv1 ;
TA+innga:taak	DemAdv1 ;
TA+kinnga:takkig	DemAdv1 ;
	DemAdv2 ; !(Immikkut ittoq, nagguik 'una' eqqarsaatigalugu)
anna+DemInterj:affa	# ;
panna+DemInterj:paffa	# ;
qanna+DemInterj:qaffa	# ;
TA+kanna+DemInterj:takanna	# ;
TA+qanna+DemInterj:taqqama	# ;
TA+sanna+DemInterj:tasama	# ;
TA+pinnga+DemInterj:tappika	# ;
innga+DemInterj:ika	# ;
TA+innga+DemInterj:taaka	# ;
TA+kinnga+DemInterj:takkiga	# ;
manna+DemInterj:massa	# ;
una+DemInterj:uffa	# ;
una+DemInterj:tassa	# ;


LEXICON IntPron	!(interrogative pronominer)
kina:ki	IntPron1 ;
suna:su	IntPron2 ;
sorleq:sorli	IntPron3 ;
qassit:qassi	IntPron4 ;

LEXICON IndefPron	!(indefinitte pronominer)
	IndefPron1 ;	!kinaluunniit
	IndefPron2 ;	!sunaluunniit
	IndefPron3 ;	!sorlerluunniit
	IndefPron4 ;	!qassilluunniit

LEXICON PersPron	!(personlige pronominer)
uanga:ua	PersPron1 ;
illit:il	PersPron2 ;

LEXICON ReflPron	!(refleksive og reciprokke pronominer)
immi	ReflPron1 ;
nammineq:nammi	ReciPron1 ;
nammineq+INNAQ:	ReciPron2 ;

LEXICON DivPron	!(uegentlige pronominer)
nalinginnaq:nalinginnaq	DivPron1 ;
toqunngaq:toqunngaq	DivPron4 ;
attaq:attaq	DivPron4 ;
katinngaq:katinngaq	DivPron4 ;
arlaq:arla	DivPron6 ;
ilaq:ila	DivPron6 ;
kisi:kisi	DivPron2 ;
kisi+LUINNAQ:kiserluinnaq	DivPron4 ;
kisi+VIK:kisivik	DivPron4 ;
kisi+KASIK:kisikasik	DivPron4 ;
kisi+NGAJAK:kisingajak	DivPron4 ;
kisi+QQISSAAQ:kiseqqissaaq	DivPron5 ;
kisi+SUAQ:kisersuaq	DivPron5 ;
kisi+NNGUAQ:kisinnguaq	DivPronNNGUAQ ;
kiserrak+DivPron+Sg:kiserrammi	K ;
tamaq:tamaq	DivPron3 ;
tamaq:tamaq	DivPron4 ;
tamaq+LUINNAQ:tamarluinnaq	DivPron4 ;
tamaq+KASIK:tamakasik	DivPron4 ;
tamaq+NGAJAK:tamangajak	DivPron4 ;
tamaq+NGAJAK=LUINNAQ:tamangajalluinnaq	DivPron4 ;
tamaq+NNGUAQ:tamannguaq	DivPronNNGUAQ ;
tamaq+QQISSAAQ:tamaqqissaaq	DivPron5 ;
tamaq+SUAQ:tamarsuaq	DivPron5 ;
tamaq+VIK:tamavik	DivPron4 ;
iluunngaq:iluunngaq	DivPron4 ;
iluunngaq+LUINNAQ:iluunngarluinnaq	DivPron4 ;
iluunngaq+QQISSAAQ:iluunngaqqissaaq	DivPron5 ;


!HUSK: at lave en regel for k og g-stammerne i demonstrative pronominer, som siger ( 'na' --> 'nga' ( k | g _ ))

LEXICON DemAdv1	!(av,pav,qav,kan,qam,sam,pik,ik,kig)
+DemAdv+Trm+Sg:%>unga	UpkiSuaq ;
+DemAdv+Trm+Sg:%>unnar	IV ;
+DemAdv+Trm+Sg:%>unnaap	XTuteXmorf ;
+DemAdv+Lok+Sg:%>ani	LokVb ;
+DemAdv+Abl+Sg:%>annga	UpkiSuaq ;
+DemAdv+Abl+Sg:%>anngaanniit	UpkiSuaq ;
+DemAdv+Abl+Sg:%>anngaaniit	UpkiSuaq ;
+DemAdv+Via+Sg:%>uuna	ViaVb ;

LEXICON DemAdv2	!(una)
TA+una+DemAdv+Trm+Sg:%>tassunga	UpkiSuaq ;
TA+una+DemAdv+Trm+Sg:%>tassunnar	IV ;
TA+una+DemAdv+Trm+Sg:%>tassunnaap	XTuteXmorf ;
una+DemAdv+Trm+Sg:%>uunga	UpkiSuaq ;
una+DemAdv+Trm+Sg:%>uungar	IV ;
una+DemAdv+Trm+Sg:%>uungaap	XTuteXmorf ;
TA+una+DemAdv+Lok+Sg:%>tassani	LokVb ;
una+DemAdv+Lok+Sg:%>uani	LokVb ;
TA+una+DemAdv+Abl+Sg:%>tassanga	UpkiSuaq ;
una+DemAdv+Abl+Sg:%>uanga	UpkiSuaq ;
TA+una+DemAdv+Abl+Sg:%>tassanngaanniit	UpkiSuaq ;
una+DemAdv+Abl+Sg:%>uanngaanniit	UpkiSuaq ;
TA+una+DemAdv+Abl+Sg:%>tassanngaaniit	UpkiSuaq ;
una+DemAdv+Abl+Sg:%>uanngaaniit	UpkiSuaq ;
TA+una+DemAdv+Via+Sg:%>tassuuna	ViaVb ;
una+DemAdv+Via+Sg:%>ugguuna	ViaVb ;

LEXICON UpkiSuaq
	K ;
+SUAQ:%>%TRUNCrsuaq	K ;
+RALAAQ=NNGUAQ:%>%TRUNCralaannguaq	K ;


LEXICON DemPron1	!(av,pav,qav,kan,qam,sam,im,pik,ik,kig,man,uv, ogsÃ¥ dem med 'TA' foran)
+DemPron+U+nv:%>naa	IV_voq ;
+DemPron+U+nv:%>kuu	IV_voqP ;
+DemPron+Abs+Sg:%>na	K ;
+DemPron+Abs+Pl:%>kua	K_plur ;
+DemPron+Abs+Pl+SUB:%>ku	K_plur ;
+DemPron+Rel+Sg:%>suma	K ;
+DemPron+Rel+Pl:%>ku	K_plur ;
+DemPron+Rel+Pl+SUB:%>kua	K_plur ;
+DemPron+Ins+Sg:%>suminnga	K ;
+DemPron+Ins+Pl:%>kuninnga	K ;
+DemPron+Trm+Sg:%>sumunnga	K ;
+DemPron+Trm+Pl:%>kununnga	K ;
+DemPron+Trm:%>sumunngar	IV ;
+DemPron+Trm:%>kununngar	IV ;
+DemPron+Trm:%>sumunnar	IV ;
+DemPron+Trm:%>sumunngaap	XTuteXmorf ;
+DemPron+Trm:%>kununngaap	XTuteXmorf ;
+DemPron+Trm:%>sumunnaap	XTuteXmorf ;
+DemPron+Lok+Sg:%>sumani	LokVb ;
+DemPron+Lok+Pl:%>kunani	LokVb ;
+DemPron+Abl+Sg:%>sumannga	K ;
+DemPron+Abl+Pl:%>kunannga	K ;
+DemPron+Via+Sg+SUB:%>sumuuna	ViaVb ;
+DemPron+Via+Pl:%>kunatigut	ViaVb ;
+DemPron+Via+Pl:%>kunuunatigut	ViaVb ;
+DemPron+Via+Pl+SUB:%>kunuuna	ViaVb ;
+DemPron+Aeq+Sg:%>sumatut	K ;
+DemPron+Aeq+Sg+SUB:%>natut	K ;
+DemPron+Aeq+Pl:%>kunatut	K ;
+DemPron+Aeq+Pl:%>kutut	K ;
+DemPron+Aeq+Pl:%>kuatut	K ;
+DemPron+Vok+Sg:%>sumaa	# ; 
+DemPron+Vok+Sg:%>sumaak	# ; 
+DemPron+Vok+Sg:%>sumaangaa	# ; 
+DemPron+Vok+Pl:%>korsii	# ;
+DemPron+Vok+Pl:%>korsiiaa	# ;

LEXICON DemPron2	!(uv)
+RALAK+KASIK+DemPron+Abs+Sg:%>%TRUNCnaralakasik	K ;
+SUAQ+DemPron+Abs+Sg:%>%TRUNCnarsuaq	K ;
+KULUK+DemPron+Abs+Sg:%>%TRUNCnakkuluk	K ;
+DemPron+U+nv:%>%TRUNCnaa	IV_voq ;
+DemPron+U+nv:%>%TRUNCkuu	IV_voqP ;
+DemPron+Abs+Sg:%>%TRUNCna	K ;
+DemPron+Abs+Pl:%>%TRUNCku	K_plur ;
+DemPron+Rel+Sg:%>%TRUNCuma	K ;
+DemPron+Rel+Pl:%>%TRUNCkua	K_plur ;
+DemPron+Ins+Sg:%>%TRUNCuminnga	K ;
+DemPron+Ins+Pl:%>%TRUNCkuninnga	K ;
+DemPron+Trm+Sg:%>%TRUNCumunnga	K ;
+DemPron+Trm+Pl:%>%TRUNCkununnga	K ;
+DemPron+Trm:%>%TRUNCumunngar	IV ;
+DemPron+Trm:%>%TRUNCkununngar	IV ;
+DemPron+Trm:%>%TRUNCumunngaap	XTuteXmorf ;
+DemPron+Trm:%>%TRUNCkununngaap	XTuteXmorf ;
!+DemPron+Lok+Sg:%>%TRUNCumani	LokVb ;	
+DemPron+Lok+Pl:%>%TRUNCkunani	LokVb ;
!+DemPron+Abl+Sg:%>%TRUNCumannga	K ;
+DemPron+Abl+Pl:%>%TRUNCkunannga	K ;
!+DemPron+Via+Sg:%>%TRUNCumuuna	ViaVb ;
+DemPron+Via+Pl:%>%TRUNCkunuunatigut	ViaVb ;
+DemPron+Via+Pl:%>%TRUNCkunatigut	ViaVb ;
+DemPron+Via+Pl+SUB:%>%TRUNCkunuuna	ViaVb ;
+DemPron+Via+Pl+SUB:%>%TRUNCkunuunatigut	ViaVb ;
+DemPron+Aeq+Sg:%>%TRUNCnatut	K ;
+DemPron+Aeq+Pl:%>%TRUNCkunatut	K ;
+DemPron+Vok+Sg:%>%TRUNCumaa	# ; 
+DemPron+Vok+Sg:%>%TRUNCumaak	# ; 
+DemPron+Vok+Sg+AA:%>%TRUNCumaangaa	# ; 
+DemPron+Vok+Pl:%>%TRUNCkorsii	# ;
+DemPron+Vok+Pl+AA:%>%TRUNCkorsiiaa	# ;
+NNGUAQ+DemPron+Vok+Sg:uumaannguaq	K ;
+NNGUAQ+DemPron+Vok+Sg+AA:uumaannguaaraa	K ;
+RUJUK+DemPron+Vok+Sg:uumarujuk	K ;
+RUJUK+DemPron+Vok+Sg+AA:uumarujungaa	K ;
+RUJUK+DemPron+Vok+Sg+AA:uumarujuungaa	K ;
+RUJUK+DemPron+Vok+Sg:uumaarujuk	K ;
+RUJUK+DemPron+Vok+Sg+AA:uumaarujuungaa	K ;


LEXICON DemPron3	!(Speciel 'TA+man:taman')
+DemPron+Rel+Sg:%>%TRUNCtuma	K ;
+DemPron+Ins+Sg:%>%TRUNCtuminnga	K ;
+DemPron+Trm+Sg:%>%TRUNCtumunnga	K ;
+DemPron+Lok+Sg:%>%TRUNCtumani	K ;
+DemPron+Abl+Sg:%>%TRUNCtumannga	K ;
+DemPron+Via+Sg:%>%TRUNCtumuuna	K ;
+DemPron+Via+Sg:%>%TRUNCtumuunakkut	K ;
+DemPron+Aeq+Sg:%>%TRUNCtumatut	K ;
+DemPron+Aeq+Sg:%>%TRUNCtumasut	K ;
+DemPron+PAK=SUAQ+Trm+Pl:%>%TRUNCkkorpassuarnut	K ;

LEXICON DemPron4	!(AA+rod)
+RALAK=KASIK+nn+DemPron+Abs+Sg:%>naralakasik	K ;
+RALAK+nn+DemPron+Abs+Sg:%>naralak	K ;
+KASIK+nn+DemPron+Abs+Sg:%>nakasik	K ;
+NNGUAQ+nn+DemPron+Abs+Sg:%>nannguaq	K ;
+SUAQ+nn+DemPron+Abs+Sg:%>narsuaq	K ;
+SUAQ+nn+DemPron+Abs+Sg:%>korsuit	K_plur ;
+DemPron+Abs+Sg:%>na	K ;
+DemPron+Abs+Pl:%>ku	K_plur ;
+DemPron+Abs+Pl:%>kua	K_plur ;


LEXICON IntPron1	!(kina:ki)
+PAK=SUAQ+nn+IntPron+Abs+Pl:%>kkorpassuit	K ;
+SUAQ+nn+IntPron+Abs+Sg:%>narsuaq	tp ;
+PIAQ+nn+IntPron+Abs+Sg:%>narpiaq	tp ; !kinarpiaanera
+IntPron+U+nv:%>naa	IV_voq ;
+IntPron+U+nv:%>kkuu	IV_voqP ;
+IntPron+Abs+Sg:%>na	K ;
+IntPron+Abs+Sg+Arch:%>su	K ;
+IntPron+Abs+Pl:%>kkut	K_plur ;
+IntPron+Rel+Sg:%>a	K ;
+IntPron+Rel+Sg+SUB:%>ap	K ;
+IntPron+Rel+Pl:%>kkut	K_plur ;
+IntPron+Ins+Sg:%>mik	K ;
+IntPron+Ins+Pl:%>kkunnik	K ;
+IntPron+Trm+Sg:%>mut	TrmVb ;
+IntPron+Trm+Pl:%>kkunnut	TrmVb ;
+IntPron+Lok+Sg:%>mi	LokVb ;
+IntPron+Lok+Pl:%>kkunni	LokVb ;
+IntPron+Abl+Sg:%>mit	AblVb ;
+IntPron+Abl+Pl:%>kkunnit	AblVb ;
+IntPron+Via+Sg:%>kkut	ViaVb ;	!kikkut? imalt. kinakkut?
+IntPron+Via+Pl:%>kkunatigut	ViaVb ;	!kikkunatigut? imalt. kikkutigut?
+IntPron+Aeq+Sg:%>natut	K ;
+IntPron+Aeq+Pl:%>kkunatut	K ;

LEXICON IntPron2	!(suna:su)
+PIAQ+IntPron:%>narpiaq	tp ; !sunarpiaava
+SUAQ+IntPron:%>narsuaq	tp ; !sunarpiaava
+IntPron+U+nv:%>naa	IV_voq ;
+IntPron+U+nv:%>uu	IV_voqP ;
+IntPron+Abs+Sg:%>na	K ;
+IntPron+Abs+Pl:%>ut	K_plur ;
+IntPron+Rel+Sg:%>up	K ;
+IntPron+Rel+Pl:%>ut	K_plur ;
+IntPron+Ins+Sg:%>mik	K ;
+IntPron+Ins+Pl:%>nik	K ;
+IntPron+Trm+Sg:%>mut	TrmVb ;
+IntPron+Trm+Pl:%>nut	TrmVb ;
+IntPron+Lok+Sg:%>mi	LokVb ;
+IntPron+Lok+Pl:%>ni	LokVb ;
+IntPron+Lok+Sg+3SgPoss:ani	LokVb ;
+IntPron+Abl+Sg:minngaanniit	AblVb ;
+IntPron+Abl+Sg:%>mit	AblVb ;
+IntPron+Abl+Pl:%>nit	AblVb ;
+IntPron+Via+Sg:%>kkut	ViaVb ;
+IntPron+Via+Pl:%>tigut	ViaVb ;
+IntPron+Aeq+Sg:%>natut	K ;
+IntPron+Aeq+Sg:%>tut	K ;
+IntPron+Aeq+Pl:%>tut	K ;

LEXICON IntPron3	!(sorleq:sorli)
+IntPron+U+nv:%>u	IV_voq ;
+IntPron+U+nv:%>u	IV_voqP ;
+IntPron+Abs+Sg:%>q	K ;
+IntPron+Abs+Pl:%>it	K_plur ;
+IntPron+Rel+Sg:%>up	K ;
+IntPron+Rel+Pl:%>it	K_plur ;
+IntPron+Ins+Sg:%>rmik	K ;
+IntPron+Ins+Pl:%>rnik	K ;
+IntPron+Trm+Sg:%>rmut	TrmVb ;
+IntPron+Trm+Pl:%>rnut	TrmVb ;
+IntPron+Lok+Sg:%>rmi	LokVb ;
+IntPron+Lok+Pl:%>rni	LokVb ;
+IntPron+Abl+Sg:%>rmit	AblVb ;
+IntPron+Abl+Pl:%>rnit	AblVb ;
+IntPron+Via+Sg:%>kkut	ViaVb ;
+IntPron+Via+Pl:%>itigut	ViaVb ;
+IntPron+Aeq+Sg:%>rtut	K ;
+IntPron+Aeq+Pl:%>ittut	K ;

LEXICON IntPron4	!(qassit:qassi)
+IntPron+U+nv:%>u	IV_voqP ;
+IntPron+Abs+Pl:%>t	K_plur ;
+IntPron+Rel+Pl:%>t	K_plur ;
+IntPron+Ins+Pl:%>nik	K ;
+IntPron+Trm+Pl:%>nut	TrmVb ;
+IntPron+Lok+Pl:%>ni	LokVb ;
+IntPron+Abl+Pl:%>nit	AblVb ;
+IntPron+Via+Pl:%>tigut	ViaVb ;
+IntPron+Aeq+Pl:%>tut	K ;

LEXICON IndefPron1	!(kinaluunniit)
kina+LUUNNIIT+IndefPron+Abs+Sg:kinaluunniit	IndefPronK ;
kina+LUUNNIIT+IndefPron+Abs+Pl:kikkulluunniit	IndefPronK ;
kina+LUUNNIIT+IndefPron+Rel+Sg:kialuunniit	IndefPronK ;
kina+LUUNNIIT+IndefPron+Rel+Sg+SUB:kialluunniit	IndefPronK ;
kina+LUUNNIIT+IndefPron+Rel+Pl:kikkulluunniit	IndefPronK ;
kina+LUUNNIIT+IndefPron+Ins+Sg:kimilluunniit	IndefPronK ;
kina+LUUNNIIT+IndefPron+Ins+Pl:kikkunnilluunniit	IndefPronK ;
kina+LUUNNIIT+IndefPron+Trm+Sg:kimulluunniit	IndefPronK ;
kina+LUUNNIIT+IndefPron+Trm+Pl:kikkunnulluunniit	IndefPronK ;
kina+LUUNNIIT+IndefPron+Lok+Sg:kimiluunniit	IndefPronK ;
kina+LUUNNIIT+IndefPron+Lok+Pl:kikkunniluunniit	IndefPronK ;
kina+LUUNNIIT+IndefPron+Abl+Sg:kimilluunniit	IndefPronK ;
kina+LUUNNIIT+IndefPron+Abl+Pl:kikkunnilluunniit	IndefPronK ;
kina+LUUNNIIT+IndefPron+Via+Sg:kikkulluuniit	IndefPronK ;	!kikkut? imalt. kinakkut?
kina+LUUNNIIT+IndefPron+Via+Pl:kikkunatigulluunniit	IndefPronK ;	!kikkunatigut? imalt. kikkutigut?
kina+LUUNNIIT+IndefPron+Aeq+Sg:kinatulluunniit	IndefPronK ;
kina+LUUNNIIT+IndefPron+Aeq+Pl:kikkunatulluunniit	IndefPronK ;

LEXICON IndefPron2	!(sunaluunniit)
suna+LUUNNIIT+IndefPron+Abs+Sg:sunaluunniit	IndefPronK ;
suna+LUUNNIIT+IndefPron+Abs+Pl:suulluunniit	IndefPronK ;
suna+LUUNNIIT+IndefPron+Rel+Sg:suulluunniit	IndefPronK ;
suna+LUUNNIIT+IndefPron+Rel+Pl:suulluunniit	IndefPronK ;
suna+LUUNNIIT+IndefPron+Ins+Sg:sumilluunniit	IndefPronK ;
suna+LUUNNIIT+IndefPron+Ins+Pl:sunilluunniit	IndefPronK ;
suna+LUUNNIIT+IndefPron+Trm+Sg:sumulluunniit	IndefPronK ;
suna+LUUNNIIT+IndefPron+Trm+Pl:sunulluunniit	IndefPronK ;
suna+LUUNNIIT+IndefPron+Lok+Sg:sumiluunniit	IndefPronK ;
suna+LUUNNIIT+IndefPron+Lok+Pl:suniluunniit	IndefPronK ;
suna+LUUNNIIT+IndefPron+Abl+Sg:sumilluunniit	IndefPronK ;
suna+LUUNNIIT+IndefPron+Abl+Pl:sunilluunniit	IndefPronK ;
suna+LUUNNIIT+IndefPron+Via+Sg:sukkulluunniit	IndefPronK ;
suna+LUUNNIIT+IndefPron+Via+Pl:sutigulluunniit	IndefPronK ;
suna+LUUNNIIT+IndefPron+Aeq+Sg:sutulluunniit	IndefPronK ;
suna+LUUNNIIT+IndefPron+Aeq+Pl:sunatulluunniit	IndefPronK ;

LEXICON IndefPron3	!(sorlerluunniit)
sorleq+LUUNNIIT+IndefPron+Abs+Sg:sorlerluunniit	IndefPronK ;
sorleq+LUUNNIIT+IndefPron+Abs+Pl:sorliilluunniit	IndefPronK ;
sorleq+LUUNNIIT+IndefPron+Rel+Sg:sorliulluunniit	IndefPronK ;
sorleq+LUUNNIIT+IndefPron+Rel+Pl:sorliilluunniit	IndefPronK ;
sorleq+LUUNNIIT+IndefPron+Ins+Sg:sorlermilluunniit	IndefPronK ;
sorleq+LUUNNIIT+IndefPron+Ins+Pl:sorlernilluunniit	IndefPronK ;
sorleq+LUUNNIIT+IndefPron+Trm+Sg:sorlermulluunniit	IndefPronK ;
sorleq+LUUNNIIT+IndefPron+Trm+Pl:sorlernulluunniit	IndefPronK ;
sorleq+LUUNNIIT+IndefPron+Lok+Sg:sorlermiluunniit	IndefPronK ;
sorleq+LUUNNIIT+IndefPron+Lok+Pl:sorlerniluunniit	IndefPronK ;
sorleq+LUUNNIIT+IndefPron+Abl+Sg:sorlermilluunniit	IndefPronK ;
sorleq+LUUNNIIT+IndefPron+Abl+Pl:sorlernilluunniit	IndefPronK ;
sorleq+LUUNNIIT+IndefPron+Via+Sg:sorlikkulluunniit	IndefPronK ;
sorleq+LUUNNIIT+IndefPron+Via+Pl:sorliitigulluunniit	IndefPronK ;
sorleq+LUUNNIIT+IndefPron+Aeq+Sg:sorlertulluunniit	IndefPronK ;
sorleq+LUUNNIIT+IndefPron+Aeq+Pl:sorliittulluunniit	IndefPronK ;

LEXICON IndefPron4	!(qassilluunniit)
qassit+LUUNNIIT+IndefPron+Abs+Pl:qassilluunniit	IndefPronK ;
qassit+LUUNNIIT+IndefPron+Rel+Pl:qassilluunniit	IndefPronK ;
qassit+LUUNNIIT+IndefPron+Ins+Pl:qassinilluunniit	IndefPronK ;
qassit+LUUNNIIT+IndefPron+Trm+Pl:qassinulluunniit	IndefPronK ;
qassit+LUUNNIIT+IndefPron+Lok+Pl:qassiniluunniit	IndefPronK ;
qassit+LUUNNIIT+IndefPron+Abl+Pl:qassinilluunniit	IndefPronK ;
qassit+LUUNNIIT+IndefPron+Via+Pl:qassitigulluunniit	IndefPronK ;
qassit+LUUNNIIT+IndefPron+Aeq+Pl:qassitulluunniit	IndefPronK ;

LEXICON IndefPronK	!(Enklitiske endelser til indefinitte pronominer)
+LI:%CLITli	# ;
+LU:%CLITlu	# ;
+MI:%CLITmi # ;
+NGOOQ:%CLITngooq	# ;
	# ;

LEXICON PersPron1	!(uanga:ua)
+SUAQ+nn+PersPron+1Sg:%>ngarsuaq	K ;
+SUAQ+nn+PersPron+1Pl:%>gorsuit	K ;
+PersPron+U+nv:%>ngaa	IV_voq ;
+PersPron+U+nv:%>guu	IV_voqP ;
+PersPron+Abs+1Sg:%>nga	K ;
+PersPron+Abs+1Pl:%>gut	K ;
+PersPron+Rel+1Sg:%>nga	K ;
+PersPron+Rel+1Pl:%>gut	K ;
+PersPron+Ins+1Sg:%>nnik	K ;
+PersPron+Ins+1Pl:%>tsinnik	K ;
+PersPron+Ins+1Pl:%>gutsinnik	K ;
+PersPron+Abl+1Sg:%>nnit	AblVb ;
+PersPron+Abl+1Pl:%>tsinnit	AblVb ;
+PersPron+Abl+1Pl:%>gutsinnit	AblVb ;
+PersPron+Lok+1Sg:%>nni	LokVb ;
+PersPron+Lok+1Pl:%>tsinni	LokAeq ;
+PersPron+Lok+1Pl:%>gutsinni	LokAeq ;
+PersPron+Trm+1Sg:%>nnut	TrmVb ;
+PersPron+Trm+1Pl:%>tsinnut	TrmVb ;
+PersPron+Trm+1Pl:%>gutsinnut	TrmVb ;
+PersPron+Via+1Sg:%>kkut	ViaVb ;
+PersPron+Via+1Pl:%>tsigut	ViaVb ;
+PersPron+Via+1Pl:%>gutsigut	ViaVb ;
+PersPron+Aeq+1Sg:%>ttut	K ;
+PersPron+Aeq+1Pl:%>tsitut	K ;
+PersPron+Aeq+1Pl:%>gutsitut	K ;

LEXICON PersPron2	!(illit:il)
+PersPron+U+nv:%>liu	IV_voq ;
+PersPron+U+nv:%>issiu	IV_voqP ;
+PersPron+Abs+2Sg:%>lit	K ;
+PersPron+Abs+2Pl:%>issi	K ;
+PersPron+Rel+2Sg:%>lit	K ;
+PersPron+Rel+2Pl:%>issi	K ;
+PersPron+Ins+2Sg:%>innik	K ;
+PersPron+Ins+2Pl:%>issinnik	K ;
+PersPron+Abl+2Sg:%>innit	AblVb ;
+PersPron+Abl+2Pl:%>issinnit	AblVb ;
+PersPron+Lok+2Sg:%>inni	LokVb ;
+PersPron+Lok+2Pl:%>issinni	LokVb ;
+PersPron+Trm+2Sg:%>innut	TrmVb ;
+PersPron+Trm+2Pl:%>issinnut	TrmVb ;
+PersPron+Via+2Sg:%>ikkut	ViaVb ;
+PersPron+Via+2Pl:%>issigut	ViaVb ;
+PersPron+Aeq+2Sg:%>ittut	K ;
+PersPron+Aeq+2Pl:%>issitut	K ;

LEXICON ReflPron1	!(immi)
+ReflPron+Ins+Sg:%>nik	K ;
+ReflPron+Ins+Pl:%>nnik	K ;
+ReflPron+Ins+Pl+1PlPoss:%>tsinnik	K ;
+ReflPron+Ins+Pl+2PlPoss:%>ssinnik	K ;
+ReflPron+Lok+Sg:%>ni	LokVb ;
+ReflPron+Lok+Pl:%>nni	LokVb ;
+ReflPron+Lok+Pl+1PlPoss:%>tsinni	LokVb ;
+ReflPron+Lok+Pl+2PlPoss:%>ssinni	LokVb ;
+ReflPron+Abl+Sg:%>nit	AblVb ;
+ReflPron+Abl+Pl:%>nnit	AblVb ;
+ReflPron+Abl+Pl+1PlPoss:%>tsinnit	AblVb ;
+ReflPron+Abl+Pl+2PlPoss:%>ssinnit	AblVb ;
+ReflPron+Trm+Sg:%>nut	TrmVb ;
+ReflPron+Trm+Pl:%>nnut	TrmVb ;
+ReflPron+Trm+Pl+1PlPoss:%>tsinnut	TrmVb ;
+ReflPron+Trm+Pl+2PlPoss:%>ssinnut	TrmVb ;
+ReflPron+Via+Sg:%>kkut	ViaVb ;
+ReflPron+Via+Pl:%>kkut	ViaVb ;
+ReflPron+Via+Pl+1PlPoss:%>tsigut	ViaVb ;
+ReflPron+Via+Pl+2PlPoss:%>ssigut	ViaVb ;
+ReflPron+Aeq+Sg:%>sut	K ;
+ReflPron+Aeq+Pl:%>ssut	K ;
+ReflPron+Aeq+Pl+1PlPoss:%>tsitut	K ;
+ReflPron+Aeq+Pl+2PlPoss:%>ssitut	K ;

LEXICON ReciPron1	!(nammineq:nammi)
+ReflPron+U+nv:%>niu	IV_voq ;
+ReflPron+U+nv:%>niu	IV_voqP ;
+PALAAQ+nn+ReflPron+Sg:%>nipalaaq	K ;
+RUJUK+nn+ReflPron+Sg:%>nerujuk	K ;
+ReflPron+Abs+Sg:%>neq	K ;
+ReflPron+Abs+Pl:%>neq	K ;
+ReflPron+Rel+Sg:%>neq	K ;
+ReflPron+Rel+Pl:%>neq	K ;
+ReflPron+Lok+Sg:%>nermi	LokVb ;
+ReflPron+Lok+Pl:%>nerni	LokVb ;
+ReflPron+Ins+Sg:%>nermik	K ;
+ReflPron+Ins+Pl:%>nernik	K ;
+ReflPron+Abl+Sg:%>nermit	AblVb ;
+ReflPron+Abl+Pl:%>nernit	AblVb ;
+ReflPron+Trm+Sg:%>nermut	TrmVb ;
+ReflPron+Trm+Pl:%>nernut	TrmVb ;
+ReflPron+Via+Sg:%>nikkut	ViaVb ;
+ReflPron+Via+Pl:%>nertigut	ViaVb ;
+ReflPron+Aeq+Sg:%>nertut	K ;
+ReflPron+Aeq+Pl:%>nertut	K ;
+ReflPron+Abs+1Sg:%>neq	K ;
+ReflPron+Abs+1Pl:%>neq	K ;
+ReflPron+Abs+2Sg:%>neq	K ;
+ReflPron+Abs+2Pl:%>neq	K ;
+ReflPron+Abs+4Sg:%>neq	K ;
+ReflPron+Abs+4Pl:%>nneq	K ;
+ReflPron+Rel+1Sg:%>neq	K ;
+ReflPron+Rel+1Pl:%>neq	K ;
+ReflPron+Rel+2Sg:%>neq	K ;
+ReflPron+Rel+2Pl:%>neq	K ;
+ReflPron+Rel+4Sg:%>neq	K ;
+ReflPron+Rel+4Pl:%>nneq	K ;
+ReflPron+Ins+Sg+1SgPoss:%>ninnik	K ;
+ReflPron+Ins+Pl+1PlPoss:%>nitsinnik	K ;
+ReflPron+Ins+Pl+1PlPoss+SUB:%>tsinnik	K ;
+ReflPron+Ins+Sg+2SgPoss:%>ninnik	K ;
+ReflPron+Ins+Pl+2PlPoss:%>nissinnik	K ;
+ReflPron+Ins+Pl+2PlPoss+SUB:%>ssinnik	K ;
+ReflPron+Ins+Sg+4SgPoss:%>nerminik	K ;
+ReflPron+Ins+Pl+4PlPoss:%>nnerminnik	K ;
+ReflPron+Ins+Pl+4PlPoss:%>nerminnik	K ;
+ReflPron+Lok+Sg+1SgPoss:%>ninni	LokVb ;
+ReflPron+Lok+Pl+1PlPoss:%>nitsinni	LokVb ;
+ReflPron+Lok+Pl+1PlPoss+SUB:%>tsinni	LokVb ;
+ReflPron+Lok+Sg+2SgPoss:%>ninni	LokVb ;
+ReflPron+Lok+Pl+2PlPoss:%>nissinni	LokVb ;
+ReflPron+Lok+Pl+2PlPoss+SUB:%>ssinni	LokVb ;
+ReflPron+Lok+Sg+4SgPoss:%>nermini	LokVb ;
+ReflPron+Lok+Pl+4PlPoss:%>nnerminni	LokVb ;
+ReflPron+Lok+Pl+4PlPoss:%>nerminni	LokVb ;
+ReflPron+Abl+Sg+1SgPoss:%>ninnit	AblVb ;
+ReflPron+Abl+Pl+1PlPoss:%>nitsinnit	AblVb ;
+ReflPron+Abl+Pl+1PlPoss+SUB:%>tsinnit	AblVb ;
+ReflPron+Abl+Sg+2SgPoss:%>ninnit	AblVb ;
+ReflPron+Abl+Pl+2PlPoss:%>nissinnit	AblVb ;
+ReflPron+Abl+Pl+2PlPoss+SUB:%>ssinnit	AblVb ;
+ReflPron+Abl+Sg+4SgPoss:%>nerminit	AblVb ;
+ReflPron+Abl+Sg+4SgPoss:%>nerminiit	AblVb ;
+ReflPron+Abl+Pl+4PlPoss:%>nnerminnit	AblVb ;
+ReflPron+Abl+Pl+4PlPoss:%>nerminnit	AblVb ;
+ReflPron+Trm+Sg+1SgPoss:%>ninnut	TrmVb ;
+ReflPron+Trm+Pl+1PlPoss:%>nitsinnut	TrmVb ;
+ReflPron+Trm+Pl+1PlPoss+SUB:%>tsinnut	TrmVb ;
+ReflPron+Trm+Sg+2SgPoss:%>ninnut	TrmVb ;
+ReflPron+Trm+Pl+2PlPoss:%>nissinnut	TrmVb ;
+ReflPron+Trm+Pl+2PlPoss+SUB:%>ssinnut	TrmVb ;
+ReflPron+Trm+Sg+4SgPoss:%>nerminut	TrmVb ;
+ReflPron+Trm+Pl+4PlPoss:%>nnerminnut	TrmVb ;
+ReflPron+Trm+Pl+4PlPoss:%>nerminnut	TrmVb ;
+ReflPron+Via+Sg+1SgPoss:%>nikkut	ViaVb ;
+ReflPron+Via+Pl+1PlPoss:%>nitsigut	ViaVb ;
+ReflPron+Via+Pl+1PlPoss+SUB:%>tsigut	ViaVb ;
+ReflPron+Via+Sg+2SgPoss:%>nikkut	ViaVb ;
+ReflPron+Via+Pl+2PlPoss:%>nissigut	ViaVb ;
+ReflPron+Via+Pl+2PlPoss+SUB:%>ssigut	ViaVb ;
+ReflPron+Via+Sg+4SgPoss:%>nermigut	ViaVb ;
+ReflPron+Via+Pl+4PlPoss:%>nnermikkut	ViaVb ;
+ReflPron+Via+Pl+4PlPoss:%>nermikkut	ViaVb ;
+ReflPron+Aeq+Sg+1SgPoss:%>nittut	K ;
+ReflPron+Aeq+Pl+1PlPoss:%>nitsitut	K ;
+ReflPron+Aeq+Pl+1PlPoss+SUB:%>tsitut	K ;
+ReflPron+Aeq+Sg+2SgPoss:%>nikkut	K ;
+ReflPron+Aeq+Pl+2PlPoss:%>nissitut	K ;
+ReflPron+Aeq+Pl+2PlPoss+SUB:%>ssitut	K ;
+ReflPron+Aeq+Sg+4SgPoss:%>nermisut	K ;
+ReflPron+Aeq+Pl+4PlPoss:%>nnermissut	K ;
+ReflPron+Aeq+Pl+4PlPoss:%>nermissut	K ;


LEXICON ReciPron2	!(namminiinnaq:)
+ReflPron+U+nv:%>namminiinnaa	IV_voq ;
+ReflPron+U+nv:%>namminiinnaa	IV_voqP ;
+ReflPron+Abs+Sg:%>namminiinnaq	K ;
+ReflPron+Abs+Pl:%>namminiinnaq	K ;
+ReflPron+Rel+Sg:%>namminiinnaq	K ;
+ReflPron+Rel+Pl:%>namminiinnaq	K ;
+ReflPron+Lok+Sg:%>namminiinnarmi	LokVb ;
+ReflPron+Lok+Pl:%>namminiinnarni	LokVb ;
+ReflPron+Ins+Sg:%>namminiinnarmik	K ;
+ReflPron+Ins+Pl:%>namminiinnarnik	K ;
+ReflPron+Abl+Sg:%>namminiinnarmit	AblVb ;
+ReflPron+Abl+Pl:%>namminiinnarnit	AblVb ;
+ReflPron+Trm+Sg:%>namminiinnarmut	TrmVb ;
+ReflPron+Trm+Pl:%>namminiinnarnut	TrmVb ;
+ReflPron+Via+Sg:%>namminiinnakkut	ViaVb ;
+ReflPron+Via+Pl:%>namminiinnartigut	ViaVb ;
+ReflPron+Aeq+Sg:%>namminiinnartut	K ;
+ReflPron+Aeq+Pl:%>namminiinnartut	K ;
+ReflPron+Abs+1Sg:%>namminiinnaq	K ;
+ReflPron+Abs+1Pl:%>namminiinnaq	K ;
+ReflPron+Abs+2Sg:%>namminiinnaq	K ;
+ReflPron+Abs+2Pl:%>namminiinnaq	K ;
+ReflPron+Abs+4Sg:%>namminiinnaq	K ;
+ReflPron+Abs+4Pl:%>namminniinnaq	K ;
+ReflPron+Rel+1Sg:%>namminiinnaq	K ;
+ReflPron+Rel+1Pl:%>namminiinnaq	K ;
+ReflPron+Rel+2Sg:%>namminiinnaq	K ;
+ReflPron+Rel+2Pl:%>namminiinnaq	K ;
+ReflPron+Rel+4Sg:%>namminiinnaq	K ;
+ReflPron+Rel+4Pl:%>namminniinnaq	K ;
+ReflPron+Ins+Sg+1SgPoss:%>namminiinnannik	K ;
+ReflPron+Ins+Pl+1PlPoss:%>namminiinnatsinnik	K ;
+ReflPron+Ins+Sg+2SgPoss:%>namminiinnannik	K ;
+ReflPron+Ins+Pl+2PlPoss:%>namminiinnassinnik	K ;
+ReflPron+Ins+Sg+4SgPoss:%>namminiinnarminik	K ;
+ReflPron+Ins+Pl+4PlPoss:%>namminiinnarminnik	K ;
+ReflPron+Lok+Sg+1SgPoss:%>namminiinnanni	LokVb ;
+ReflPron+Lok+Pl+1PlPoss:%>namminiinnatsinni	LokVb ;
+ReflPron+Lok+Sg+2SgPoss:%>namminiinnanni	LokVb ;
+ReflPron+Lok+Pl+2PlPoss:%>namminiinnassinni	LokVb ;
+ReflPron+Lok+Sg+4SgPoss:%>namminiinnarmini	LokVb ;
+ReflPron+Lok+Pl+4PlPoss:%>namminiinnarminni	LokVb ;
+ReflPron+Abl+Sg+1SgPoss:%>namminiinnannit	AblVb ;
+ReflPron+Abl+Pl+1PlPoss:%>namminiinnatsinnit	AblVb ;
+ReflPron+Abl+Sg+2SgPoss:%>namminiinnannit	AblVb ;
+ReflPron+Abl+Pl+2PlPoss:%>namminiinnassinnit	AblVb ;
+ReflPron+Abl+Sg+4SgPoss:%>namminiinnarminit	AblVb ;
+ReflPron+Abl+Pl+4PlPoss:%>namminiinnarminnit	AblVb ;
+ReflPron+Trm+Sg+1SgPoss:%>namminiinnannut	TrmVb ;
+ReflPron+Trm+Pl+1PlPoss:%>namminiinnatsinnut	TrmVb ;
+ReflPron+Trm+Sg+2SgPoss:%>namminiinnannut	TrmVb ;
+ReflPron+Trm+Pl+2PlPoss:%>namminiinnassinnut	TrmVb ;
+ReflPron+Trm+Sg+4SgPoss:%>namminiinnarminut	TrmVb ;
+ReflPron+Trm+Pl+4PlPoss:%>namminiinnarminnut	TrmVb ;
+ReflPron+Via+Sg+1SgPoss:%>namminiinnakkut	ViaVb ;
+ReflPron+Via+Pl+1PlPoss:%>namminiinnatsigut	ViaVb ;
+ReflPron+Via+Sg+2SgPoss:%>namminiinnakkut	ViaVb ;
+ReflPron+Via+Pl+2PlPoss:%>namminiinnassigut	ViaVb ;
+ReflPron+Via+Sg+4SgPoss:%>namminiinnarmigut	ViaVb ;
+ReflPron+Via+Pl+4PlPoss:%>namminiinnarmikkut	ViaVb ;
+ReflPron+Aeq+Sg+1SgPoss:%>namminiinnattut	K ;
+ReflPron+Aeq+Pl+1PlPoss:%>namminiinnatsitut	K ;
+ReflPron+Aeq+Sg+2SgPoss:%>namminiinnakkut	K ;
+ReflPron+Aeq+Pl+2PlPoss:%>namminiinnassitut	K ;
+ReflPron+Aeq+Sg+4SgPoss:%>namminiinnarmisut	K ;
+ReflPron+Aeq+Pl+4PlPoss:%>namminiinnarmissut	K ;

LEXICON DivPron1	!(nalinginnaq, det er ogsÃ¥ en anden mulighed. Nemlig at sende nalinginnaq til 'LEXICON Z2-qZmorf', som er de leksemer som ender med -innaq)
+DivPron+U+nv:%>%TRUNCa	IV_voq ;
+DivPron+Abs+Pl:%>%TRUNCa	IV_voqP ;
+DivPron+Abs:	K ;
+DivPron+Abs+Pl:%>%TRUNCit	K_plur ;
+DivPron+Abs+Sg+1SgPoss:%ga	K ;
+DivPron+Abs+Sg+2SgPoss:%>%TRUNCat	K ;
+DivPron+Abs+Sg+3SgPoss:%>%TRUNCa	K ;
+DivPron+Abs+Sg+4SgPoss:%>%TRUNCni	K ;
+DivPron+Abs+Pl+1SgPoss:%>%TRUNCkka	K ;
+DivPron+Abs+Pl+2SgPoss:%>%TRUNCtit	K ;
+DivPron+Abs+Pl+3SgPoss:%>%TRUNCi	K ;
+DivPron+Abs+Pl+4SgPoss:%>%TRUNCni	K ;
+DivPron+Abs+Sg+1PlPoss:%>%TRUNCrput	K ;
+DivPron+Abs+Sg+2PlPoss:%>%TRUNCrsi	K ;
+DivPron+Abs+Sg+3PlPoss:%>%TRUNCat	K ;
+DivPron+Abs+Sg+4PlPoss:%>%TRUNCrtik	K ;
+DivPron+Abs+Pl+1PlPoss:%>%TRUNCgut	K ;
+DivPron+Abs+Pl+2PlPoss:%>%TRUNCsi	K ;
+DivPron+Abs+Pl+3PlPoss:%>%TRUNCat	K ;
+DivPron+Abs+Pl+4PlPoss:%>%TRUNCtik	K ;
+DivPron+Rel+Sg:%>%TRUNCap	K ;
+DivPron+Rel+Pl:%>%TRUNCat	K_plur ;
+DivPron+Rel+Sg+1SgPoss:%>ma	K ;
+DivPron+Rel+Sg+2SgPoss:%>%TRUNCrpit	K ;
+DivPron+Rel+Sg+3SgPoss:%>%TRUNCata	K ;
+DivPron+Rel+Sg+4SgPoss:%>mi	K ;
+DivPron+Rel+Pl+1SgPoss:%>%TRUNCrma	K ;
+DivPron+Rel+Pl+2SgPoss:%>%TRUNCppit	K ;
+DivPron+Rel+Pl+3SgPoss:%>%TRUNCata	K ;
+DivPron+Rel+Pl+4SgPoss:%>mi	K ;
+DivPron+Rel+Sg+1PlPoss:%>%TRUNCtta	K ; 
+DivPron+Rel+Sg+2PlPoss:%>%TRUNCssi	K ;
+DivPron+Rel+Sg+3PlPoss:%>%TRUNCasa	K ;
+DivPron+Rel+Sg+4PlPoss:%>mik	K ;
+DivPron+Rel+Pl+1PlPoss:%>%TRUNCtta	K ;
+DivPron+Rel+Pl+2PlPoss:%>%TRUNCssi	K ;
+DivPron+Rel+Pl+3PlPoss:%>%TRUNCasa	K ;
+DivPron+Rel+Pl+4PlPoss:%>mik	K ;
+DivPron+Trm+Sg:%>mut	TrmVb ;
+DivPron+Trm+Pl:%>%TRUNCrnut	TrmVb ;
+DivPron+Trm+Sg+1SgPoss:%>%TRUNCnnut	TrmVb ;
+DivPron+Trm+Sg+2SgPoss:%>%TRUNCnnut	TrmVb ;
+DivPron+Trm+Sg+3SgPoss:%>%TRUNCanut	TrmVb ;
+DivPron+Trm+Sg+4SgPoss:%>%TRUNCrminut	TrmVb ;
+DivPron+Trm+Pl+1SgPoss:%>%TRUNCnnut	TrmVb ;
+DivPron+Trm+Pl+2SgPoss:%>%TRUNCnnut	TrmVb ;
+DivPron+Trm+Pl+3SgPoss:%>%TRUNCanut	TrmVb ;
+DivPron+Trm+Pl+4SgPoss:%>%TRUNCrminut	TrmVb ;
+DivPron+Trm+Sg+1PlPoss:%>%TRUNCtsinnut	TrmVb ; 
+DivPron+Trm+Sg+2PlPoss:%>%TRUNCssinnut	TrmVb ;
+DivPron+Trm+Sg+3PlPoss:%>%TRUNCannut	TrmVb ;
+DivPron+Trm+Sg+4PlPoss:%>%TRUNCrminnut	TrmVb ;
+DivPron+Trm+Pl+1PlPoss:%>%TRUNCtsinnut	TrmVb ;
+DivPron+Trm+Pl+2PlPoss:%>%TRUNCssinnut	TrmVb ;
+DivPron+Trm+Pl+3PlPoss:%>%TRUNCannut	TrmVb ;
+DivPron+Trm+Pl+4PlPoss:%>%TRUNCrminnut	TrmVb ;
+DivPron+Abl+Sg:%>%TRUNCrmit	AblVb ;
+DivPron+Abl+Pl:%>%TRUNCrnit	AblVb ;
+DivPron+Abl+Sg+1SgPoss:%>%TRUNCnnit	AblVb ;
+DivPron+Abl+Sg+2SgPoss:%>%TRUNCnnit	AblVb ;
+DivPron+Abl+Sg+3SgPoss:%>%TRUNCanit	AblVb ;
+DivPron+Abl+Sg+4SgPoss:%>%TRUNCrminit	AblVb ;
+DivPron+Abl+Pl+1SgPoss:%>%TRUNCnnit	AblVb ;
+DivPron+Abl+Pl+2SgPoss:%>%TRUNCnnit	AblVb ;
+DivPron+Abl+Pl+3SgPoss:%>%TRUNCanit	AblVb ;
+DivPron+Abl+Pl+4SgPoss:%>%TRUNCrminit	AblVb ;
+DivPron+Abl+Sg+1PlPoss:%>%TRUNCtsinnit	AblVb ; 
+DivPron+Abl+Sg+2PlPoss:%>%TRUNCssinnit	AblVb ;
+DivPron+Abl+Sg+3PlPoss:%>%TRUNCannit	AblVb ;
+DivPron+Abl+Sg+4PlPoss:%>%TRUNCrminnit	AblVb ;
+DivPron+Abl+Pl+1PlPoss:%>%TRUNCtsinnit	AblVb ;
+DivPron+Abl+Pl+2PlPoss:%>%TRUNCssinnit	AblVb ;
+DivPron+Abl+Pl+3PlPoss:%>%TRUNCannit	AblVb ;
+DivPron+Abl+Pl+4PlPoss:%>%TRUNCrminnit	AblVb ;
+DivPron+Abl+Sg:%>%TRUNCrmiit	K ;
+DivPron+Abl+Pl:%>%TRUNCrniit	K_plur ;
+DivPron+Abl+Sg+1SgPoss:%>%TRUNCnniit	K ;
+DivPron+Abl+Sg+2SgPoss:%>%TRUNCnniit	K ;
+DivPron+Abl+Sg+3SgPoss:%>%TRUNCaniit	K ;
+DivPron+Abl+Sg+4SgPoss:%>%TRUNCrminiit	K ;
+DivPron+Abl+Pl+1SgPoss:%>%TRUNCnniit	K ;
+DivPron+Abl+Pl+2SgPoss:%>%TRUNCnniit	K ;
+DivPron+Abl+Pl+3SgPoss:%>%TRUNCaniit	K ;
+DivPron+Abl+Pl+4SgPoss:%>%TRUNCrminiit	K ;
+DivPron+Abl+Sg+1PlPoss:%>%TRUNCtsinniit	K ; 
+DivPron+Abl+Sg+2PlPoss:%>%TRUNCssinniit	K ;
+DivPron+Abl+Sg+3PlPoss:%>%TRUNCanniit	K ;
+DivPron+Abl+Sg+4PlPoss:%>%TRUNCrminniit	K ;
+DivPron+Abl+Pl+1PlPoss:%>%TRUNCtsinniit	K ;
+DivPron+Abl+Pl+2PlPoss:%>%TRUNCssinniit	K ;
+DivPron+Abl+Pl+3PlPoss:%>%TRUNCanniit	K ;
+DivPron+Abl+Pl+4PlPoss:%>%TRUNCrminniit	K ;
+DivPron+Lok+Sg:%>%TRUNCrmi	LokVb ;
+DivPron+Lok+Pl:%>%TRUNCrni	LokVb ;
+DivPron+Lok+Sg+1SgPoss:%>%TRUNCnni	LokVb ;
+DivPron+Lok+Sg+2SgPoss:%>%TRUNCnni	LokVb ;
+DivPron+Lok+Sg+3SgPoss:%>%TRUNCani	LokVb ;
+DivPron+Lok+Sg+4SgPoss:%>%TRUNCrmini	LokVb ;
+DivPron+Lok+Pl+1SgPoss:%>%TRUNCnni	LokVb ;
+DivPron+Lok+Pl+2SgPoss:%>%TRUNCnni	LokVb ;
+DivPron+Lok+Pl+3SgPoss:%>%TRUNCani	LokVb ;
+DivPron+Lok+Pl+4SgPoss:%>%TRUNCrmini	LokVb ;
+DivPron+Lok+Sg+1PlPoss:%>%TRUNCtsinni	LokVb ; 
+DivPron+Lok+Sg+2PlPoss:%>%TRUNCssinni	LokVb ;
+DivPron+Lok+Sg+3PlPoss:%>%TRUNCanni	LokVb ;
+DivPron+Lok+Sg+4PlPoss:%>%TRUNCrminni	LokVb ;
+DivPron+Lok+Pl+1PlPoss:%>%TRUNCtsinni	LokVb ;
+DivPron+Lok+Pl+2PlPoss:%>%TRUNCssinni	LokVb ;
+DivPron+Lok+Pl+3PlPoss:%>%TRUNCanni	LokVb ;
+DivPron+Lok+Pl+4PlPoss:%>%TRUNCrminni	LokVb ;
+DivPron+Aeq+Sg:%>%TRUNCrtut	K ;
+DivPron+Aeq+Pl:%>%TRUNCrtut	K_plur ;
+DivPron+Aeq+Sg+1SgPoss:%>%TRUNCttut	K ;
+DivPron+Aeq+Sg+2SgPoss:%>%TRUNCttut	K ;
+DivPron+Aeq+Sg+3SgPoss:%>%TRUNCatut	K ;
+DivPron+Aeq+Sg+4SgPoss:%>%TRUNCrmisut	K ;
+DivPron+Aeq+Pl+1SgPoss:%>%TRUNCttut	K ;
+DivPron+Aeq+Pl+2SgPoss:%>%TRUNCttut	K ;
+DivPron+Aeq+Pl+3SgPoss:%>%TRUNCasut	K ;
+DivPron+Aeq+Pl+4SgPoss:%>%TRUNCrmisut	K ;
+DivPron+Aeq+Sg+1PlPoss:%>%TRUNCtsitut	K ; 
+DivPron+Aeq+Sg+2PlPoss:%>%TRUNCssitut	K ;
+DivPron+Aeq+Sg+3PlPoss:%>%TRUNCattut	K ;
+DivPron+Aeq+Sg+4PlPoss:%>%TRUNCrmittut	K ;
+DivPron+Aeq+Pl+1PlPoss:%>%TRUNCtsitut	K ;
+DivPron+Aeq+Pl+2PlPoss:%>%TRUNCssitut	K ;
+DivPron+Aeq+Pl+3PlPoss:%>%TRUNCattut	K ; 
+DivPron+Aeq+Pl+4PlPoss:%>%TRUNCrmittut	K ;
+DivPron+Ins+Sg:%>%TRUNCrmik	K ; 
+DivPron+Ins+Pl:%>%TRUNCrnik	K_plur ;
+DivPron+Ins+Sg+1SgPoss:%>%TRUNCnnik	K ;
+DivPron+Ins+Sg+2SgPoss:%>%TRUNCnnik	K ;
+DivPron+Ins+Sg+3SgPoss:%>%TRUNCanik	K ;
+DivPron+Ins+Sg+4SgPoss:%>%TRUNCrminik	K ;
+DivPron+Ins+Pl+1SgPoss:%>%TRUNCnnik	K ;
+DivPron+Ins+Pl+2SgPoss:%>%TRUNCnnik	K ;
+DivPron+Ins+Pl+3SgPoss:%>%TRUNCanik	K ;
+DivPron+Ins+Pl+4SgPoss:%>%TRUNCrminik	K ;
+DivPron+Ins+Sg+1PlPoss:%>%TRUNCtsinnik	K ; 
+DivPron+Ins+Sg+2PlPoss:%>%TRUNCssinnik	K ;
+DivPron+Ins+Sg+3PlPoss:%>%TRUNCannik	K ;
+DivPron+Ins+Sg+4PlPoss:%>%TRUNCrminnik	K ;
+DivPron+Ins+Pl+1PlPoss:%>%TRUNCtsinnik	K ;
+DivPron+Ins+Pl+2PlPoss:%>%TRUNCssinnik	K ;
+DivPron+Ins+Pl+3PlPoss:%>%TRUNCannik	K ;
+DivPron+Ins+Pl+4PlPoss:%>%TRUNCrminnik	K ;
+DivPron+Via+Sg:%>%TRUNCkkut	ViaVb ;
+DivPron+Via+Pl:%>%TRUNCrtigut	ViaVb ;
+DivPron+Via+Sg+1SgPoss:%>%TRUNCkkut	ViaVb ;
+DivPron+Via+Sg+2SgPoss:%>%TRUNCkkut	ViaVb ;
+DivPron+Via+Sg+3SgPoss:%>%TRUNCagut	ViaVb ;
+DivPron+Via+Sg+3SgPoss:%>%TRUNCatigut	ViaVb ;
+DivPron+Via+Sg+4SgPoss:%>%TRUNCrmigut	ViaVb ;
+DivPron+Via+Pl+1SgPoss:%>%TRUNCkkut	ViaVb ;
+DivPron+Via+Pl+2SgPoss:%>%TRUNCkkut	ViaVb ;
+DivPron+Via+Pl+3SgPoss:%>%TRUNCasigut	ViaVb ;
+DivPron+Via+Pl+4SgPoss:%>%TRUNCrmigut	ViaVb ;
+DivPron+Via+Sg+1PlPoss:%>%TRUNCtsigut	ViaVb ;
+DivPron+Via+Sg+2PlPoss:%>%TRUNCssigut	ViaVb ;
+DivPron+Via+Sg+3PlPoss:%>%TRUNCatigut	ViaVb ;
+DivPron+Via+Sg+4PlPoss:%>%TRUNCrmikkut	ViaVb ;
+DivPron+Via+Pl+1PlPoss:%>%TRUNCtsigut	ViaVb ;
+DivPron+Via+Pl+2PlPoss:%>%TRUNCssigut	ViaVb ;
+DivPron+Via+Pl+3PlPoss:%>%TRUNCasigut	ViaVb ; 
+DivPron+Via+Pl+4PlPoss:%>%TRUNCrmikkut	ViaVb ;

LEXICON DivPron2	!(kisi)
+DivPron+U+nv:%>miu	IV_voq ;
+DivPron+Abs+1Sg:%>ma	K ;
+DivPron+Abs+2Sg:%>vit	K ;
+DivPron+Abs+3Sg:%>at	K ;
+DivPron+Abs+4Sg:%>mi	K ;
+DivPron+Abs+1Pl:%>tta	K ; 
+DivPron+Abs+2Pl:%>ssi	K ;
+DivPron+Abs+3Pl:%>isa	K ;
+DivPron+Abs+4Pl:%>mik	K ;
+DivPron+Rel+1Sg:%>ma	K ;
+DivPron+Rel+2Sg:%>vit	K ;
+DivPron+Rel+3Sg:%>at	K ;
+DivPron+Rel+4Sg:%>mi	K ;
+DivPron+Rel+1Pl:%>tta	K ; 
+DivPron+Rel+2Pl:%>ssi	K ;
+DivPron+Rel+3Pl:%>isa	K ;
+DivPron+Rel+4Pl:%>mik	K ;
+DivPron+Trm+Sg+1SgPoss:%>nnut	TrmVb ;
+DivPron+Trm+Sg+2SgPoss:%>nnut	TrmVb ;
+DivPron+Trm+Sg+3SgPoss:%>anut	TrmVb ;
+DivPron+Trm+Sg+4SgPoss:%>minut	TrmVb ;
+DivPron+Trm+Pl+1PlPoss:%>tsinnut	TrmVb ; 
+DivPron+Trm+Pl+2PlPoss:%>ssinnut	TrmVb ;
+DivPron+Trm+Pl+3PlPoss:%>annut	TrmVb ;
+DivPron+Trm+Pl+4PlPoss:%>minnut	TrmVb ;
+DivPron+Abl+Sg+1SgPoss:%>nnit	AblVb ; 
+DivPron+Abl+Sg+2SgPoss:%>nnit	AblVb ; 
+DivPron+Abl+Sg+3SgPoss:%>anit	AblVb ; 
+DivPron+Abl+Sg+4SgPoss:%>minit	AblVb ; 
+DivPron+Abl+Pl+1PlPoss:%>tsinnit	AblVb ;  
+DivPron+Abl+Pl+2PlPoss:%>ssinnit	AblVb ; 
+DivPron+Abl+Pl+3PlPoss:%>annit	AblVb ; 
+DivPron+Abl+Pl+4PlPoss:%>minnit	AblVb ; 
+DivPron+Abl+Sg+1SgPoss:%>nniit	K ; 
+DivPron+Abl+Sg+2SgPoss:%>nniit	K ; 
+DivPron+Abl+Sg+3SgPoss:%>aniit	K ; 
+DivPron+Abl+Sg+4SgPoss:%>miniit	K ; 
+DivPron+Abl+Pl+1PlPoss:%>tsinniit	K ;  
+DivPron+Abl+Pl+2PlPoss:%>ssinniit	K ; 
+DivPron+Abl+Pl+3PlPoss:%>anniit	K ; 
+DivPron+Abl+Pl+4PlPoss:%>minniit	K ; 
+DivPron+Lok+Sg+1SgPoss:%>nni	LokVb ;
+DivPron+Lok+Sg+2SgPoss:%>nni	LokVb ;
+DivPron+Lok+Sg+3SgPoss:%>ani	LokVb ;
+DivPron+Lok+Sg+4SgPoss:%>mini	LokVb ;
+DivPron+Lok+Pl+1PlPoss:%>tsinni	LokVb ;
+DivPron+Lok+Pl+2PlPoss:%>ssinni	LokVb ;
+DivPron+Lok+Pl+3PlPoss:%>anni	LokVb ;
+DivPron+Lok+Pl+4PlPoss:%>minni	LokVb ;
+DivPron+Ins+Sg+1SgPoss:%>nnik	K ;
+DivPron+Ins+Sg+2SgPoss:%>nnik	K ;
+DivPron+Ins+Sg+3SgPoss:%>anik	K ;
+DivPron+Ins+Sg+4SgPoss:%>minik	K ;
+DivPron+Ins+Pl+1PlPoss:%>tsinnik	K ; 
+DivPron+Ins+Pl+2PlPoss:%>ssinnik	K ;
+DivPron+Ins+Pl+3PlPoss:%>annik	K ;
+DivPron+Ins+Pl+4PlPoss:%>minnik	K ;
+DivPron+Via+Sg+1SgPoss:%>kkut	K ;
+DivPron+Via+Sg+2SgPoss:%>kkut	K ;
+DivPron+Via+Sg+3SgPoss:%>agut	K ;
+DivPron+Via+Pl+3SgPoss:%>atigut	K ;
+DivPron+Via+Sg+4SgPoss:%>migut	K ;
+DivPron+Via+Pl+1PlPoss:%>tsigut	K ; 
+DivPron+Via+Pl+2PlPoss:%>ssigut	K ;
+DivPron+Via+Sg+3PlPoss:%>atigut	K ;
+DivPron+Via+Pl+3PlPoss:%>asigut	K ;
+DivPron+Via+Pl+4PlPoss:%>mikkut	K ;
+DivPron+Aeq+Sg+1SgPoss:%>ttut	K ;
+DivPron+Aeq+Sg+2SgPoss:%>ttut	K ;
+DivPron+Aeq+Sg+3SgPoss:%>atut	K ;
+DivPron+Aeq+Sg+4SgPoss:%>misut	K ;
+DivPron+Aeq+Pl+1PlPoss:%>tsitut	K ; 
+DivPron+Aeq+Pl+2PlPoss:%>ssitut	K ;
+DivPron+Aeq+Pl+3PlPoss:%>attut	K ;
+DivPron+Aeq+Sg+4PlPoss:%>mittut	K ;
+DivPron+Aeq+Pl+4PlPoss:%>missut	K ;

LEXICON DivPron3	!(tamaq)
+DivPron+Lok:%>%TRUNCni	LokVb ;
+DivPron+Abl:%>%TRUNCnit	AblVb ;
+DivPron+Trm:%>%TRUNCnut	TrmVb ;
+DivPron+Ins:%>%TRUNCnik	K ;
+DivPron+Via:%>%TRUNCtigut	ViaVb ;
+DivPron+Aeq:%>%TRUNCtut	K ;

LEXICON DivPronNNGUAQ	!(tamaq+NNGUAQ)
+DivPron+Abs+1Sg:%>ma	K ;
+DivPron+Abs+2Sg:%>%TRUNCppit	K ;
+DivPron+Abs+4Sg:%>mi	K ;
+DivPron+Abs+1Pl:%>%TRUNCtta	K ; 
+DivPron+Abs+2Pl:%>%TRUNCssi	K ;
+DivPron+Abs+3Pl:%>%VTRUNCisa	K ;
+DivPron+Abs+4Pl:%>mik	K ;
+DivPron+Rel+1Sg:%>ma	K ;
+DivPron+Rel+2Sg:%>%TRUNCppit	K ;
+DivPron+Rel+4Sg:%>mi	K ;
+DivPron+Rel+1Pl:%>%TRUNCtta	K ; 
+DivPron+Rel+2Pl:%>%TRUNCssi	K ;
+DivPron+Rel+3Pl:%>%VTRUNCisa	K ;
+DivPron+Rel+4Pl:%>mik	K ;
+DivPron+Trm+Pl+1PlPoss:%>%TRUNCtsinnut	TrmVb ; 
+DivPron+Trm+Pl+2PlPoss:%>%TRUNCssinnut	TrmVb ;
+DivPron+Trm+Pl+3PlPoss:%>%VTRUNCnut	TrmVb ;
+DivPron+Trm+Pl+4PlPoss:%>minnut	TrmVb ;
+DivPron+Abl+Pl+1PlPoss:%>%TRUNCtsinnit	AblVb ;  
+DivPron+Abl+Pl+2PlPoss:%>%TRUNCssinnit	AblVb ; 
+DivPron+Abl+Pl+3PlPoss:%>%TRUNCannit	AblVb ; 
+DivPron+Abl+Pl+4PlPoss:%>minnit	AblVb ; 
+DivPron+Abl+Pl+1PlPoss:%>%TRUNCtsinniit	K ;  
+DivPron+Abl+Pl+2PlPoss:%>%TRUNCssinniit	K ; 
+DivPron+Abl+Pl+3PlPoss:%>%TRUNCanniit	K ; 
+DivPron+Abl+Pl+4PlPoss:%>minniit	K ; 
+DivPron+Lok+Pl+1PlPoss:%>%TRUNCtsinni	LokVb ;
+DivPron+Lok+Pl+2PlPoss:%>%TRUNCssinni	LokVb ;
+DivPron+Lok+Pl+3PlPoss:%>%TRUNCanni	LokVb ;
+DivPron+Lok+Pl+4PlPoss:%>minni	LokVb ;
+DivPron+Ins+Pl+1PlPoss:%>%TRUNCtsinnik	K ; 
+DivPron+Ins+Pl+2PlPoss:%>%TRUNCssinnik	K ;
+DivPron+Ins+Pl+3PlPoss:%>%TRUNCannik	K ;
+DivPron+Ins+Pl+4PlPoss:%>minnik	K ;
+DivPron+Via+Pl+1PlPoss:%>%TRUNCtsigut	ViaVb ; 
+DivPron+Via+Pl+2PlPoss:%>%TRUNCssigut	ViaVb ;
+DivPron+Via+Pl+3PlPoss:%>%TRUNCatigut	ViaVb ;
+DivPron+Via+Pl+3PlPoss:%>%TRUNCagut	ViaVb ;
+DivPron+Via+Pl+4PlPoss:%>mikkut	ViaVb ;
+DivPron+Aeq+Pl+1PlPoss:%>%TRUNCtsitut	K ; 
+DivPron+Aeq+Pl+2PlPoss:%>%TRUNCssitut	K ;
+DivPron+Aeq+Pl+3PlPoss:%>%TRUNCattut	K ;
+DivPron+Aeq+Pl+4PlPoss:%>mittut	K ;

LEXICON DivPron4	!(tamaq, iluunngaq, katinngaq, toqunngaq, attaq, kiserluinnaq, tamarluinnaq, iluunngarluinnaq, kisivik, kisingajak, tamangajak)
+DivPron+Abs+1Sg:%>ma	K ;
+DivPron+Abs+2Sg:%>pit	K ;
+DivPron+Abs+3Sg:%>%TRUNCat	K ;
+DivPron+Abs+4Sg:%>mi	K ;
+DivPron+Abs+1Pl:%>%TRUNCtta	K ; 
+DivPron+Abs+2Pl:%>%TRUNCssi	K ;
+DivPron+Abs+3Pl:%>%TRUNCisa	K ;
+DivPron+Abs+4Pl:%>mik	K ;
+DivPron+Rel+1Sg:%>ma	K ;
+DivPron+Rel+2Sg:%>pit	K ;
+DivPron+Rel+3Sg:%>%TRUNCat	K ;
+DivPron+Rel+4Sg:%>mi	K ;
+DivPron+Rel+1Pl:%>%TRUNCtta	K ; 
+DivPron+Rel+2Pl:%>%TRUNCssi	K ;
+DivPron+Rel+3Pl:%>%TRUNCisa	K ;
+DivPron+Rel+4Pl:%>mik	K ;
+DivPron+Trm+Sg+1SgPoss:%>%TRUNCnnut	TrmVb ;
+DivPron+Trm+Sg+2SgPoss:%>%TRUNCnnut	TrmVb ;
+DivPron+Trm+Sg+3SgPoss:%>%TRUNCanut	TrmVb ;
+DivPron+Trm+Sg+4SgPoss:%>minut	TrmVb ;
+DivPron+Trm+Pl+1PlPoss:%>%TRUNCtsinnut	TrmVb ; 
+DivPron+Trm+Pl+2PlPoss:%>%TRUNCssinnut	TrmVb ;
+DivPron+Trm+Pl+3PlPoss:%>%TRUNCannut	TrmVb ;
+DivPron+Trm+Pl+4PlPoss:%>minnut	TrmVb ;
+DivPron+Abl+Sg+1SgPoss:%>%TRUNCnnit	AblVb ; 
+DivPron+Abl+Sg+2SgPoss:%>%TRUNCnnit	AblVb ; 
+DivPron+Abl+Sg+3SgPoss:%>%TRUNCanit	AblVb ; 
+DivPron+Abl+Sg+4SgPoss:%>minit	AblVb ; 
+DivPron+Abl+Pl+1PlPoss:%>%TRUNCtsinnit	AblVb ;  
+DivPron+Abl+Pl+2PlPoss:%>%TRUNCssinnit	AblVb ; 
+DivPron+Abl+Pl+3PlPoss:%>%TRUNCannit	AblVb ; 
+DivPron+Abl+Pl+4PlPoss:%>minnit	AblVb ; 
+DivPron+Abl+Sg+1SgPoss:%>%TRUNCnniit	K ; 
+DivPron+Abl+Sg+2SgPoss:%>%TRUNCnniit	K ; 
+DivPron+Abl+Sg+3SgPoss:%>%TRUNCaniit	K ; 
+DivPron+Abl+Sg+4SgPoss:%>miniit	K ; 
+DivPron+Abl+Pl+1PlPoss:%>%TRUNCtsinniit	K ;  
+DivPron+Abl+Pl+2PlPoss:%>%TRUNCssinniit	K ; 
+DivPron+Abl+Pl+3PlPoss:%>%TRUNCanniit	K ; 
+DivPron+Abl+Pl+4PlPoss:%>minniit	K ; 
+DivPron+Lok+Sg+1SgPoss:%>%TRUNCnni	LokVb ;
+DivPron+Lok+Sg+2SgPoss:%>%TRUNCnni	LokVb ;
+DivPron+Lok+Sg+3SgPoss:%>%TRUNCani	LokVb ;
+DivPron+Lok+Sg+4SgPoss:%>mini	LokVb ;
+DivPron+Lok+Pl+1PlPoss:%>%TRUNCtsinni	LokVb ;
+DivPron+Lok+Pl+2PlPoss:%>%TRUNCssinni	LokVb ;
+DivPron+Lok+Pl+3PlPoss:%>%TRUNCanni	LokVb ;
+DivPron+Lok+Pl+4PlPoss:%>minni	LokVb ;
+DivPron+Ins+Sg+1SgPoss:%>%TRUNCnnik	K ;
+DivPron+Ins+Sg+2SgPoss:%>%TRUNCnnik	K ;
+DivPron+Ins+Sg+3SgPoss:%>%TRUNCanik	K ;
+DivPron+Ins+Sg+4SgPoss:%>minik	K ;
+DivPron+Ins+Pl+1PlPoss:%>%TRUNCtsinnik	K ; 
+DivPron+Ins+Pl+2PlPoss:%>%TRUNCssinnik	K ;
+DivPron+Ins+Pl+3PlPoss:%>%TRUNCannik	K ;
+DivPron+Ins+Pl+4PlPoss:%>minnik	K ;
+DivPron+Via+Sg+1SgPoss:%>%TRUNCkkut	ViaVb ;
+DivPron+Via+Sg+2SgPoss:%>%TRUNCkkut	ViaVb ;
+DivPron+Via+Sg+3SgPoss:%>%TRUNCagut	ViaVb ;
+DivPron+Via+Sg+3SgPoss:%>%TRUNCatigut	ViaVb ;
+DivPron+Via+Sg+4SgPoss:%>migut	ViaVb ;
+DivPron+Via+Pl+1PlPoss:%>%TRUNCtsigut	ViaVb ; 
+DivPron+Via+Pl+2PlPoss:%>%TRUNCssigut	ViaVb ;
+DivPron+Via+Pl+3PlPoss:%>%TRUNCatigut	ViaVb ;
+DivPron+Via+Pl+3PlPoss:%>%TRUNCagut	ViaVb ;
+DivPron+Via+Pl+4PlPoss:%>mikkut	ViaVb ;
+DivPron+Aeq+Sg+1SgPoss:%>%TRUNCttut	K ;
+DivPron+Aeq+Sg+2SgPoss:%>%TRUNCttut	K ;
+DivPron+Aeq+Sg+3SgPoss:%>%TRUNCatut	K ;
+DivPron+Aeq+Sg+4SgPoss:%>misut	K ;
+DivPron+Aeq+Pl+1PlPoss:%>%TRUNCtsitut	K ; 
+DivPron+Aeq+Pl+2PlPoss:%>%TRUNCssitut	K ;
+DivPron+Aeq+Pl+3PlPoss:%>%TRUNCattut	K ;
+DivPron+Aeq+Pl+4PlPoss:%>mittut	K ;

LEXICON DivPron5	!(kiseqqissaaq, tamaqqissaaq, iluunngaqqissaaq)
+DivPron+Abs+Sg+1SgPoss:%>ma	K ;
+DivPron+Abs+Pl+1PlPoss:%>%TRUNCtta	K ;
+DivPron+Abs+Sg+2SgPoss:%>pit	K ;
+DivPron+Abs+Pl+2PlPoss:%>%TRUNCssi	K ;
+DivPron+Abs+Sg+3SgPoss:%>%TRUNCt	K ;
+DivPron+Abs+Pl+3PlPoss:%>%VCTRUNCisa	K ;	!%VCTRUNC = trunkerer bÃ¥de stammens sidste og nÃ¦stsidste som er vokal, dvs. '-aq' i '-qissaaq'.
+DivPron+Abs+Sg+4SgPoss:%>mi	K ;
+DivPron+Abs+Pl+4PlPoss:%>mik	K ;
+DivPron+Rel+Sg+1SgPoss:%>ma	K ;
+DivPron+Rel+Pl+1PlPoss:%>%TRUNCtta	K ;
+DivPron+Rel+Sg+2SgPoss:%>pit	K ;
+DivPron+Rel+Pl+2PlPoss:%>%TRUNCssi	K ;
+DivPron+Rel+Sg+3SgPoss:%>%TRUNCt	K ;
+DivPron+Rel+Pl+3PlPoss:%>%VCTRUNCisa	K ;
+DivPron+Rel+Sg+4SgPoss:%>mi	K ;
+DivPron+Rel+Pl+4PlPoss:%>mik	K ;
+DivPron+Ins+Sg+1SgPoss:%>%TRUNCnnik	K ;
+DivPron+Ins+Pl+1PlPoss:%>%TRUNCtsinnik	K ;
+DivPron+Ins+Sg+2SgPoss:%>%TRUNCnnik	K ;
+DivPron+Ins+Pl+2PlPoss:%>%TRUNCssinnik	K ;
+DivPron+Ins+Sg+3SgPoss:%>%TRUNCnik	K ;
+DivPron+Ins+Pl+3PlPoss:%>%TRUNCvannik	K ;
+DivPron+Ins+Sg+4SgPoss:%>minik	K ;
+DivPron+Ins+Pl+4PlPoss:%>minnik	K ;
+DivPron+Lok+Sg+1SgPoss:%>%TRUNCnni	LokVb ;
+DivPron+Lok+Pl+1PlPoss:%>%TRUNCtsinni	LokVb ;
+DivPron+Lok+Sg+2SgPoss:%>%TRUNCnni	LokVb ;
+DivPron+Lok+Pl+2PlPoss:%>%TRUNCssinni	LokVb ;
+DivPron+Lok+Sg+3SgPoss:%>%TRUNCni	K ;
+DivPron+Lok+Pl+3PlPoss:%>%TRUNCvanni	K ;
+DivPron+Lok+Sg+4SgPoss:%>mini	K ;
+DivPron+Lok+Pl+4PlPoss:%>minni	K ;
+DivPron+Abl+Sg+1SgPoss:%>%TRUNCnnit	AblVb ;
+DivPron+Abl+Pl+1PlPoss:%>%TRUNCtsinnit	AblVb ;
+DivPron+Abl+Sg+2SgPoss:%>%TRUNCnnit	AblVb ;
+DivPron+Abl+Pl+2PlPoss:%>%TRUNCssinnit	AblVb ;
+DivPron+Abl+Sg+3SgPoss:%>%TRUNCnit	K ;
+DivPron+Abl+Pl+3PlPoss:%>%TRUNCvannit	K ;
+DivPron+Abl+Sg+4SgPoss:%>minit	K ;
+DivPron+Abl+Pl+4PlPoss:%>minnit	K ;
+DivPron+Trm+Sg+1SgPoss:%>%TRUNCnnut	TrmVb ;
+DivPron+Trm+Pl+1PlPoss:%>%TRUNCtsinnut	TrmVb ;
+DivPron+Trm+Sg+2SgPoss:%>%TRUNCnnut	TrmVb ;
+DivPron+Trm+Pl+2PlPoss:%>%TRUNCssinnut	TrmVb ;
+DivPron+Trm+Sg+3SgPoss:%>%TRUNCnut	K ;
+DivPron+Trm+Pl+3PlPoss:%>%TRUNCvannut	K ;
+DivPron+Trm+Sg+4SgPoss:%>minut	K ;
+DivPron+Trm+Pl+4PlPoss:%>minnut	K ;
+DivPron+Via+Sg+1SgPoss:%>%TRUNCkkut	ViaVb ;
+DivPron+Via+Pl+1PlPoss:%>%TRUNCtsigut	ViaVb ;
+DivPron+Via+Sg+2SgPoss:%>%TRUNCkkut	ViaVb ;
+DivPron+Via+Pl+2PlPoss:%>%TRUNCssigut	ViaVb ;
+DivPron+Via+Sg+3SgPoss:%>%TRUNCgut	K ;
+DivPron+Via+Pl+3PlPoss:%>%TRUNCvatigut	K ;
+DivPron+Via+Sg+4SgPoss:%>migut	K ;
+DivPron+Via+Pl+4PlPoss:%>mikkut	K ;
+DivPron+Aeq+Sg+1SgPoss:%>%TRUNCttut	K ;
+DivPron+Aeq+Pl+1PlPoss:%>%TRUNCtsitut	K ;
+DivPron+Aeq+Sg+2SgPoss:%>%TRUNCttut	K ;
+DivPron+Aeq+Pl+2PlPoss:%>%TRUNCssitut	K ;
+DivPron+Aeq+Sg+3SgPoss:%>%TRUNCtut	K ;
+DivPron+Aeq+Pl+3PlPoss:%>%TRUNCvattut	K ;
+DivPron+Aeq+Sg+4SgPoss:%>misut	K ;
+DivPron+Aeq+Pl+4PlPoss:%>missut	K ;

LEXICON DivPron6	!(Arla*, og ila*, kun med possessive endelser eller affikser)
+DivPron+Abs+Sg+1SgPoss:%ga	K ;
+DivPron+Abs+Sg+2SgPoss:%>t	K ;
+DivPron+Abs+Sg+3SgPoss:%>a	K ;
+DivPron+Abs+Sg+4SgPoss:%>ni	K ;
+DivPron+Abs+Sg+1PlPoss:%>rput	K ;
+DivPron+Abs+Sg+2PlPoss:%>rsi	K ;
+DivPron+Abs+Sg+3PlPoss:%>at	K ;
+DivPron+Abs+Sg+4PlPoss:%>rtik	K ;
+DivPron+Abs+Pl+1SgPoss:%>kka	K ;
+DivPron+Abs+Pl+2SgPoss:%>tit	K ;
+DivPron+Abs+Pl+3SgPoss:%>i	K ;
+DivPron+Abs+Pl+4SgPoss:%>ni	K ;
+DivPron+Abs+Pl+1PlPoss:%>gut	K ;
+DivPron+Abs+Pl+2PlPoss:%>si	K ;
+DivPron+Abs+Pl+3PlPoss:%>at	K ;
+DivPron+Abs+Pl+4PlPoss:%>tik	K ;
+DivPron+Rel+Sg+1SgPoss:%>ma	K ;
+DivPron+Rel+Sg+2SgPoss:%>rpit	K ;
+DivPron+Rel+Sg+3SgPoss:%>ata	K ;
+DivPron+Rel+Sg+4SgPoss:%>mi	K ;
+DivPron+Rel+Sg+1PlPoss:%>tta	K ;
+DivPron+Rel+Sg+2PlPoss:%>ssi	K ;
+DivPron+Rel+Sg+3PlPoss:%>asa	K ;
+DivPron+Rel+Sg+4PlPoss:%>mik	K ;
+DivPron+Rel+Pl+1SgPoss:%>mma	K ;
+DivPron+Rel+Pl+2SgPoss:%>ppit	K ;
+DivPron+Rel+Pl+3SgPoss:%>asa	K ;
+DivPron+Rel+Pl+4SgPoss:%>mi	K ;
+DivPron+Rel+Pl+1PlPoss:%>tta	K ;
+DivPron+Rel+Pl+2PlPoss:%>ssi	K ;
+DivPron+Rel+Pl+3PlPoss:%>asa	K ;
+DivPron+Rel+Pl+4PlPoss:%>mik	K ;
+DivPron+Lok+Sg+1SgPoss:%>nni	LokVb ;
+DivPron+Lok+Sg+2SgPoss:%>nni	LokVb ;
+DivPron+Lok+Sg+3SgPoss:%>ani	LokVb ;
+DivPron+Lok+Sg+4SgPoss:%>mini	LokVb ;
+DivPron+Lok+Sg+1PlPoss:%>tsinni	LokVb ;
+DivPron+Lok+Sg+2PlPoss:%>ssinni	LokVb ;
+DivPron+Lok+Sg+3PlPoss:%>anni	LokVb ;
+DivPron+Lok+Sg+4PlPoss:%>minni	LokVb ;
+DivPron+Lok+Pl+1SgPoss:%>tsinni	LokVb ;
+DivPron+Lok+Pl+2SgPoss:%>ssinni	LokVb ;
+DivPron+Lok+Pl+3SgPoss:%>ani	LokVb ;
+DivPron+Lok+Pl+4SgPoss:%>minni	LokVb ;
+DivPron+Lok+Pl+1PlPoss:%>tsinni	LokVb ;
+DivPron+Lok+Pl+2PlPoss:%>ssinni	LokVb ;
+DivPron+Lok+Pl+3PlPoss:%>anni	LokVb ;
+DivPron+Lok+Pl+4PlPoss:%>minni	LokVb ;
+DivPron+Trm+Sg+1SgPoss:%>nnut	TrmVb ;
+DivPron+Trm+Sg+2SgPoss:%>nnut	TrmVb ;
+DivPron+Trm+Sg+3SgPoss:%>anut	TrmVb ;
+DivPron+Trm+Sg+4SgPoss:%>minut	TrmVb ;
+DivPron+Trm+Sg+1PlPoss:%>tsinnut	TrmVb ;
+DivPron+Trm+Sg+2PlPoss:%>ssinnut	TrmVb ;
+DivPron+Trm+Sg+3PlPoss:%>annut	TrmVb ;
+DivPron+Trm+Sg+4PlPoss:%>minnut	TrmVb ;
+DivPron+Trm+Pl+1SgPoss:%>nnut	TrmVb ;
+DivPron+Trm+Pl+2SgPoss:%>nnut	TrmVb ;
+DivPron+Trm+Pl+3SgPoss:%>anut	TrmVb ;
+DivPron+Trm+Pl+4SgPoss:%>minnut	TrmVb ;
+DivPron+Trm+Pl+1PlPoss:%>tsinnut	TrmVb ;
+DivPron+Trm+Pl+2PlPoss:%>ssinnut	TrmVb ;
+DivPron+Trm+Pl+3PlPoss:%>annut	TrmVb ;
+DivPron+Trm+Pl+4PlPoss:%>minnut	TrmVb ;
+DivPron+Abl+Sg+1SgPoss:%>nnit	AblVb ;
+DivPron+Abl+Sg+2SgPoss:%>nnit	AblVb ;
+DivPron+Abl+Sg+3SgPoss:%>anit	AblVb ;
+DivPron+Abl+Sg+4SgPoss:%>minit	AblVb ;
+DivPron+Abl+Sg+1PlPoss:%>tsinnit	AblVb ;
+DivPron+Abl+Sg+2PlPoss:%>ssinnit	AblVb ;
+DivPron+Abl+Sg+3PlPoss:%>annit	AblVb ;
+DivPron+Abl+Sg+4PlPoss:%>minnit	AblVb ;
+DivPron+Abl+Pl+1SgPoss:%>nnit	AblVb ;
+DivPron+Abl+Pl+2SgPoss:%>nnit	AblVb ;
+DivPron+Abl+Pl+3SgPoss:%>anit	AblVb ;
+DivPron+Abl+Pl+4SgPoss:%>minnit	AblVb ;
+DivPron+Abl+Pl+1PlPoss:%>tsinnit	AblVb ;
+DivPron+Abl+Pl+2PlPoss:%>ssinnit	AblVb ;
+DivPron+Abl+Pl+3PlPoss:%>annit	AblVb ;
+DivPron+Abl+Pl+4PlPoss:%>minnit	AblVb ;
+DivPron+Ins+Sg+1SgPoss:%>nnik	K ;
+DivPron+Ins+Sg+2SgPoss:%>nnik	K ;
+DivPron+Ins+Sg+3SgPoss:%>anik	K ;
+DivPron+Ins+Sg+4SgPoss:%>minik	K ;
+DivPron+Ins+Sg+1PlPoss:%>tsinnik	K ;
+DivPron+Ins+Sg+2PlPoss:%>ssinnik	K ;
+DivPron+Ins+Sg+3PlPoss:%>annik	K ;
+DivPron+Ins+Sg+4PlPoss:%>minnik	K ;
+DivPron+Ins+Pl+1SgPoss:%>tsinnik	K ;
+DivPron+Ins+Pl+2SgPoss:%>ssinnik	K ;
+DivPron+Ins+Pl+3SgPoss:%>anik	K ;
+DivPron+Ins+Pl+4SgPoss:%>minnik	K ;
+DivPron+Ins+Pl+1PlPoss:%>tsinnik	K ;
+DivPron+Ins+Pl+2PlPoss:%>ssinnik	K ;
+DivPron+Ins+Pl+3PlPoss:%>annik	K ;
+DivPron+Ins+Pl+4PlPoss:%>minnik	K ;
+DivPron+Via+Sg+1SgPoss:%>kkut	ViaVb ;
+DivPron+Via+Sg+2SgPoss:%>kkut	ViaVb ;
+DivPron+Via+Sg+3SgPoss:%>agut	ViaVb ;
+DivPron+Via+Sg+4SgPoss:%>migut	ViaVb ;
+DivPron+Via+Sg+1PlPoss:%>tsigut	ViaVb ;
+DivPron+Via+Sg+2PlPoss:%>ssigut	ViaVb ;
+DivPron+Via+Sg+3PlPoss:%>agut	ViaVb ;
+DivPron+Via+Sg+4PlPoss:%>mikkut	ViaVb ;
+DivPron+Via+Pl+1SgPoss:%>tsigut	ViaVb ;
+DivPron+Via+Pl+2SgPoss:%>ssigut	ViaVb ;
+DivPron+Via+Pl+3SgPoss:%>atigut	ViaVb ;
+DivPron+Via+Pl+4SgPoss:%>migut	ViaVb ;
+DivPron+Via+Pl+1PlPoss:%>tsigut	ViaVb ;
+DivPron+Via+Pl+2PlPoss:%>ssigut	ViaVb ;
+DivPron+Via+Pl+3PlPoss:%>atigut	ViaVb ;
+DivPron+Via+Pl+4PlPoss:%>mikkut	ViaVb ;
+DivPron+Aeq+Sg+1SgPoss:%>ttut	K ;
+DivPron+Aeq+Sg+2SgPoss:%>ttut	K ;
+DivPron+Aeq+Sg+3SgPoss:%>atut	K ;
+DivPron+Aeq+Sg+4SgPoss:%>misut	K ;
+DivPron+Aeq+Sg+1PlPoss:%>tsitut	K ;
+DivPron+Aeq+Sg+2PlPoss:%>ssitut	K ;
+DivPron+Aeq+Sg+3PlPoss:%>attut	K ;
+DivPron+Aeq+Sg+4PlPoss:%>mittut	K ;
+DivPron+Aeq+Pl+1SgPoss:%>tsitut	K ;
+DivPron+Aeq+Pl+2SgPoss:%>ssitut	K ;
+DivPron+Aeq+Pl+3SgPoss:%>atut	K ;
+DivPron+Aeq+Pl+4SgPoss:%>misut	K ;
+DivPron+Aeq+Pl+1PlPoss:%>tsitut	K ;
+DivPron+Aeq+Pl+2PlPoss:%>ssitut	K ;
+DivPron+Aeq+Pl+3PlPoss:%>attut	K ;
+DivPron+Aeq+Pl+4PlPoss:%>mittut	K ;

