LEXICON Verbum
affanniartip	IV ;
aggeqqusigaluar	IV ;
aggeqqusi	IV ;
aggeriar	IV ;
agger	IV ;
aggersitaa	IV ;
aggeruma	IV ;
aggerumajuinaar	IV ;
aggerumajunnaar	IV ;
aggerunnar	IV ;
aggia	IV ;
aggiasoor	IV ;
agginngitsoor	IV ;
aggiunnasor	TVschwa ;
aggiussiartor	IV ;
aggiussi	IV ;
aggiussivig	TVschwa ;
aggiaar	IV ;
aggooraa	IV ;
aggoqatigiissip	TV ;
aggor	IV ;
aggornersiaritip	TV ;
aggornersiar	TVschwa ;
aggortip	TV ;
aggortissinnaa	IV ;
aggortissinnaa	TV ;
aggortitsi	IV ;
aggor	TV ;
agguagarsi	IV ;
agguaqatigiip	XIPXmorf ;
agguaqatigiissip	TV ;
agguaqatigiissitsi	IV ;
agguaqatig	TVschwa ;
agguarfig	TVschwa ;
agguar	IV ;
agguarneqarsinnaagaluar	IV ;
agguarneqarsinnaa	IV ;
agguartip	TV ;
agguar	TV ;
agguataari	IV ;
agguataar	TV ;
aggueqqissaar	IV ;
aggula	IV ;
aggulavallaar	IV ;
agguusersor	TV ;
agguusior	IV ;
agguutisi	IV ;
agguaa	IV ;
agguaap	TV ;
agiar	IV ;
agiarrap	XIPXmorf ;
agiarsuar	IV ;
agiar	TV ;
agior	IV ;
agior	TV ;
agissap	XIPXmorf ;
agissarissi	IV ;
agissarissivip	XIiXmorf ;
agissarissorsuu	IV ;
agiup	XTuteXmorf ;
agiussi	IV ;
agiussaa	IV ;
agiutissaqqip	XIiXmorf ;
agiutaarser	IV ;
agiuaar	IV ;
agiaama	IV ;
agusup	IV ;
ajagar	IV ;
ajagarrap	IV ;
ajag	TVschwa ;
ajagula	IV ;
ajagulalaar	IV ;
ajagullalaar	IV ;
ajagullar	IV ;
ajagutar	IV ;
ajagutar	TV ;
ajagutser	TV ;
ajagutaarup	IV ;
ajakap	TV ;
ajakattartip	IV ;
ajakattaa	IV ;
ajakattaannar	TV ;
ajakkap	XIPXmorf ;
ajakkisip	TV ;
ajakkisaar	IV ;
ajakkisaartip	TV ;
ajakkaa	IV ;
ajakkaar	IV ;
ajakkaar	TVschwa ;
ajakkaarup	TV ;
ajalor	IV ;
ajalu	IV ;
ajalunaveeqqutig	TVschwa ;
ajalusoor	IV ;
ajalusoortip	TV ;
ajalusoortivip	TV ;
ajangig	TVschwa ;
ajangip	IV ;
ajangisip	TV ;
ajangisaar	TV ;
ajangitip	TV ;
ajaper	IV ;
ajaper	XTiXmorf ;
ajapersoor	IV ;
ajap	IV ;
ajappallaar	TV ;
ajappattorfig	TVschwa ;
ajappattor	IV ;
ajappattor	TV ;
ajappup	XTuteXmorf ;
ajapputivip	TV ;
ajappaar	IV ;
ajappaartor	IV ;
ajap	TV ;
ajaqqiffig	TVschwa ;
ajaqqip	IV ;
ajaqqisip	TV ;
ajaraap	IV ;
ajaraar	IV ;
ajasoor	IV ;
ajasoornar	IV ;
ajasoornarluinnar	IV ;
ajasoortip	TV ;
ajasoortivip	TV ;
ajasoorutigivip	TV ;
ajasoorutig	TVschwa ;
ajassar	IV ;
ajassar	TV ;
ajassersor	TV ;
ajassersui	IV ;
ajasser	TV ;
ajassup	TV ;
ajassussi	IV ;
ajassutivip	TV ;
ajassaa	IV ;
ajatsi	IV ;
ajatsip	IV ;
﻿ajattorneqarsor	IVschwa ;
ajattor	TV ;
ajattaa	IV ;
ajattaavallaar	IV ;
ajjajaartor	IV ;
ajoqerpalup	IV ;
ajoqersornerlup	TV ;
ajoqersortig	TVschwa ;
ajoqersor	TV ;
ajoqersortaa	IV ;
ajoqersuiartortip	TV ;
ajoqersuiartortitaa	IV ;
ajoqersui	IV ;
ajoqersuinerlup	IV ;
ajoqersuup	XTuteXmorf ;
ajoqersuussi	IV ;
ajoqer	XTiXmorf ;
ajoqiitissaa	IV ;
ajoqimukar	IV ;
ajoqinngor	IV ;
ajoqinngortip	IV ;
ajoqinngortip	TV ;
ajoqinngortitsi	IV ;
ajoqinngortitsisuu	IV ;
ajoqiu	IV ;
ajoqiuneru	IV ;
ajoqusersor	TV ;
ajoqusersui	IV ;
ajoquser	XIiXmorf ;
ajoquser	XTiXmorf ;
ajoqusii	IV ;
ajoqusiisoqassagaluar	IV ;
ajoquteqalaaraluar	IV ;
ajoquteqalaar	IV ;
ajoquteqanngivip	XIiXmorf ;
ajoquteqarner	IV ;
ajoquteqarpalup	IV ;
ajoqutig	IVschwa ;
ajoqutig	TVschwa ;
ajoqutissarsig	TVschwa ;
ajoqutissarsi	IV ;
ajoqutissarsivig	TVschwa ;
ajoqutaa	IV ;
ajoraluar	IV ;
ajorikkup	TV ;
ajorinngor	IV ;
ajorinngorsar	TV ;
ajorinngorser	XTiXmorf ;
ajorinngujuitsuler	TV ;
ajorinnip	IV ;
ajorinnippallaar	IV ;
ajorisassaa	IV ;
ajorisassaannaa	IV ;
ajorisassaannaanngivip	XIiXmorf ;
ajorissaa	IV ;
ajor	IV ;
ajorluinnar	IV ;
ajornakusoor	IV ;
ajornakusoortip	TV ;
ajornakusoortitsi	IV ;
ajornakusoorutaa	IV ;
ajornanngilluinnar	IV ;
ajornannginnerutip	TV ;
ajornannginaar	TV ;
ajornannginaavip	TV ;
ajornanngitsor	TVschwa ;
ajornanngitsunnguu	IV ;
ajornanngitsunnguusor	TVschwa ;
ajornaqutig	TVschwa ;
ajornarasor	IVschwa ;
ajornarasor	TVschwa ;
ajornarasug	TVschwa ;
ajornar	IV ;
ajornarnerar	TV ;
ajornarsi	IV ;
ajornarsivip	XIiXmorf ;
ajornarsaar	IV ;
ajornarsaarpallaar	IV ;
ajornartoor	IV ;
ajornartoorutaa	IV ;
ajornartoqanngivip	XIiXmorf ;
ajornartorsior	IV ;
ajornartorsiuler	XIiXmorf ;
ajornartorsiutigigaluar	TV ;
ajornartorsiutiginngivip	XTiXmorf ;
ajornartorsiutig	IVschwa ;
ajornartorsiutig	TVschwa ;
ajornartorsiutaagaluar	IV ;
ajornartorsiutaa	IV ;
ajornartorsiutaanaviar	IV ;
ajornartorsiutaanngivip	XIiXmorf ;
ajornasug	TVschwa ;
ajornasaar	IV ;
ajornasaarpallaar	IV ;
ajornaviar	IV ;
ajornerar	IV ;
ajornerar	TV ;
ajorneruler	IV ;
ajorneruler	XIiXmorf ;
ajornaap	XItsXmorf ;
ajornaasaar	IV ;
ajornaatsunnguu	IV ;
ajorpallaanngikkaluar	IV ;
ajorpallaar	IV ;
ajorpianngikkaluar	IV ;
ajorpiar	IV ;
ajorsangaar	IV ;
ajorsapaler	XIiXmorf ;
ajorsapap	IV ;
ajorsar	IV ;
ajorsarnar	IV ;
ajorsarnaap	XItsXmorf ;
ajorsarnaaqutaa	IV ;
ajorsartip	TV ;
ajorsi	IV ;
ajorsip	IV ;
ajorsip	TV ;
ajorsitsaar	IV ;
ajorsitsaar	TV ;
ajorsittoor	IV ;
ajorsi	TV ;
ajorsivip	IV ;
ajorsivip	XIiXmorf ;
ajorsaap	IV ;
ajorsaari	IV ;
ajorsaar	TV ;
ajorsaatiginartip	TV ;
ajorsaatiginngikkaluar	TV ;
ajorsaatig	IVschwa ;
ajorsaatig	TVschwa ;
ajorsaataarup	IV ;
ajortisar	TV ;
ajortisaari	IV ;
ajortisaariniutaa	IV ;
ajortisaariniaannar	IV ;
ajortoor	IV ;
ajortorsuu	IV ;
ajortuliffig	TVschwa ;
ajortuli	IV ;
ajortulioqqip	IV ;
ajortuliorfiginnip	IV ;
ajortuliorfig	TVschwa ;
ajortulior	IV ;
ajortuliorneru	IV ;
ajortuliortuu	IV ;
ajortumeeri	IV ;
ajortumeer	IV ;
ajortumeer	TV ;
ajortumeer	XTiXmorf ;
ajortunngor	IV ;
ajortunngorsar	TV ;
ajortunngorsimavallaar	IV ;
ajortunnguja	IV ;
ajortunngujallaar	IV ;
ajortunngujaap	XItsXmorf ;
ajortunngujaatsuu	IV ;
ajor	TV ;
ajor	TVschwa ;
ajortaajar	TV ;
ajortaajaa	IV ;
ajortaap	XItsXmorf ;
ajortaarup	IV ;
ajortaatsuu	IV ;
ajorukkup	TV ;
ajorukkussi	IV ;
ajorunaq	K ;
ajorunar	IV ;
ajorunngor	IV ;
ajorunnaamiimi	IV ;
ajorunnaami	IV ;
ajorunnaar	IV ;
ajorunnaarsar	TV ;
ajorunnaarser	XTiXmorf ;
ajorunnaarsip	TV ;
ajorunnaarsitsi	IV ;
ajorunnaarsitsisar	IV ;
ajorunnaarsaataa	IV ;
ajorunnaar	XIiXmorf ;
ajorusuutig	IVschwa ;
ajorusuutig	TVschwa ;
ajoruummer	IV ;
ajoruummisip	TV ;
ajoruummisitsi	IV ;
ajuallakkajup	IV ;
ajuallakkaluar	IV ;
ajuallannar	IV ;
ajuallap	IV ;
ajuallassaar	TV ;
ajuallatsip	TV ;
ajuallatsitsi	IV ;
ajuallatsitsissutaa	IV ;
ajuallatsitaa	IV ;
ajuallaatiginnip	IV ;
ajuallaatig	TVschwa ;
ajuar	IV ;
ajugaaffigineqanngitsoor	IV ;
ajugaaffig	TVschwa ;
ajugaa	IV ;
ajugaalluar	IV ;
ajugaalluavip	XIiXmorf ;
ajugaaniup	XIutePXmorf ;
ajugaaniup	XIutePXmorf ;﻿akullarter		XTPXmorf ;
ajugaaqqavip	IV ;
ajugaaqqavip	XIiXmorf ;
ajugaaqqip	IV ;
ajugaarup	IV ;
ajugaarutivip	XIiXmorf ;
ajugaasimaar	IV ;
ajugaasimaarpaluip	XIiXmorf ;
ajugaasimaarpalup	IV ;
ajugaasimaarutig	TVschwa ;
ajugaavip	XIiXmorf ;
ajuip	XIiXmorf ;
ajuissor	IV ;
ajuissortoqanngikkaluar	IV ;
ajuisaar	IV ;
ajukasip	IV ;
ajukkuffig	TVschwa ;
ajukkulup	IV ;
ajukkunnanngivikkaluar	IV ;
ajukkunnanngivip	XIiXmorf ;
ajukkunnar	IV ;
ajukkunnaap	XItsXmorf ;
ajukkunnaatsuu	IV ;
ajukkup	IV ;
ajukkup	TV ;
ajukkussuar	IV ;
ajukkutaarsup	IV ;
ajukulup	IV ;
ajukulup	TV ;
ajulersar	IV ;
ajuler	XIiXmorf ;
ajulisaannar	IV ;
ajuliutig	TVschwa ;
ajuliutaa	IV ;
ajullaar	IVschwa ;
ajungajap	IV ;
ajungaar	IV ;
ajunngiginar	IV ;
ajunngig	TVschwa ;
ajunngikkallar	IV ;
ajunngikkaluar	IV ;
ajunngilluar	IV ;
ajunngilluinnar	IV ;
ajunnginnerpaa	IV ;
ajunnginnerpaassagaluar	IV ;
ajunnginneru	IV ;
ajunnginneruler	XIiXmorf ;
ajunnginnerussagaluar	IV ;
ajunnginnerussangatip	TV ;
ajunnginnerutip	TV ;
ajunnginnerutissagaluar	TV ;
ajunnginngilaq	K ;
ajunnginniar	IV ;
ajunnginniartuusaar	IV ;
ajunnginniartuusaarpallaar	IV ;
ajunnginaar	TV ;
ajunngissi	IV ;
ajunngisaarfig	TVschwa ;
ajunngisaar	IV ;
ajunngisaarpallaar	IV ;
ajunngisaarutig	TVschwa ;
ajunngitsuli	IV ;
ajunngitsuliorfig	TVschwa ;
ajunngitsulior	IV ;
ajunngitsuliorneru	IV ;
ajunngitsuutip	TV ;
ajunngivikkaluar	IV ;
ajunngivip	XIiXmorf ;
ajunaaler	IV ;
ajunaaler	XIiXmorf ;
ajunaangajap	IV ;
ajunaaqqajar	IV ;
ajunaar	IV ;
ajunaarneqartip	TV ;
ajunaarnersuaqartip	TV ;
ajunaarnersuaqassagaluar	IV ;
ajunaarsar	TV ;
ajunaarsimassagaluar	IV ;
ajunaarsimassangatip	TV ;
ajunaartip	TV ;
ajunaartitsi	IV ;
ajunaartitsiniutig	TVschwa ;
ajunaartussaagaluar	IV ;
ajunaar	TV ;
ajupajaaraluar	IV ;
ajupajaar	IV ;
ajupap	IV ;
ajupataaraluar	IV ;
ajupataar	IV ;
ajuperaar	IV ;
ajup	IV ;
ajup	TV ;
ajusisip	IV ;
ajusi	TV ;
ajussagunanngikkaluar	IV ;
ajussagunanngivip	XIiXmorf ;
ajussagunar	IV ;
ajussanngilluinnar	IV ;
ajussaar	IV ;
ajutooqqip	IV ;
ajutoor	IV ;
ajutoorluinnaler	XIiXmorf ;
ajutoorluinnar	IV ;
ajutoornersuaqartip	TV ;
ajutoor	TV ;
ajutsi	IV ;
ajutuuip	IV ;
ajuulluar	IV ;
ajuummi	IV ;
ajuummissutig	TVschwa ;
ajuummissutissaa	IV ;
ajuunnaviar	IV ;
ajuunniup	IV ;
ajuup	XTuteXmorf ;
ajuusar	IV ;
ajuussi	IV ;
ajuusaaraluar	IV ;
ajuusaar	IV ;
ajuusaarutigigaluar	TV ;
ajuusaarutiginerar	TV ;
ajuusaarutiginnip	IV ;
ajuusaarutig	TVschwa ;
ajuutigiler	TV ;
ajuutigiler	XTiXmorf ;
ajuutiginaraluar	IV ;
ajuutiginar	IV ;
ajuutiginnikkaluar	IV ;
ajuutiginnilersoor	IV ;
ajuutiginnilersoor	TV ;
ajuutiginniler	XIiXmorf ;
ajuutiginnip	IV ;
ajuutig	TVschwa ;
ajuutaa	IV ;
ajaagutser	TV ;
ajaajaartor	IV ;
ajaalersor	TV ;
ajaami	TV ;
ajaap	IV ;
ajaappialior	IV ;
ajaappiar	IV ;
ajaappissior	IV ;
ajaar	IV ;
ajaar	TVschwa ;
ajaasar	TVschwa ;
ajaasaarar	TVschwa ;
akeerup	IV ;
akeerutsip	TV ;
akeqanngingajap	IV ;
akeqartip	IV ;
akeqartip	TV ;
akeqartitsi	IV ;
akeqqer	IV ;
akeqqersimaakuginnar	IV ;
akeqqersimaar	IV ;
akeqqersimaarpalup	IV ;
akeqqiup	XIuteXmorf ;
akeqqiup	XTuteXmorf ;
akeqqiussi	IV ;
akeqqugaluar	IV ;
akeqqugaluar	TV ;
akeqqu	IV ;
akeqqup	IV ;
akeqqup	TV ;
akeqqu	TV ;
akeramaar	TV ;
akerariip	XIPXmorf ;
akerartor	IV ;
akerartor	TV ;
akerartui	IV ;
akerartuisar	IV ;
akerartuup	IV ;
akerartuutaa	IV ;
akerfinikip	XItsXmorf ;
akerfinilersor	TV ;
akerleriilluinnartuu	IV ;
akerleriilluinnar	XIPXmorf ;
akerleriip	XIPXmorf ;
akerleriissutig	TVschwa ;
akerleriissutaa	IV ;
akerler	TVschwa ;
akerlilersor	TV ;
akerlilersui	IV ;
akerlilersuinerpalaar	IV ;
akerlilersuiniaannar	IV ;
akerlilersuisuu	IV ;
akerliler	XTiXmorf ;
akerlilii	IV ;
akerliuallaar	IV ;
akerliuffig	IVschwa ;
akerliuffig	TVschwa ;
akerliu	IV ;
akerliuniaannar	IV ;
akernap	TV ;
akernassi	IV ;
akersior	IV ;
akersor	TV ;
akersuuffiu	IV ;
akersuup	IV ;
akeruusior	IV ;
akeruusior	TV ;
akeraa	IV ;
akialiar	IV ;
akianeer	IV ;
akianukar	IV ;
akiaqataa	IV ;
akiarrap	XIPXmorf ;
akiartip	IV ;
akiar	TV ;
akiar	XIPXmorf ;
akigip	XIiXmorf ;
akigissaartip	TV ;
akigissaartitsi	IV ;
akigissaartitsisar	IV ;
akigissaartitsisuu	IV ;
akigissaar	XIPXmorf ;
akigitinniag	TVschwa ;
akig	TVschwa ;
akiillersip	TV ;
akiillersitassaa	IV ;
akiillersitassaanngivip	XIiXmorf ;
akiiller	XIiXmorf ;
akiilli	IV ;
akiillisip	TV ;
akiilli	TV ;
akiip	XItsXmorf ;
akiisorsi	IV ;
akiisorsi	TV ;
akiitsoqarpallaar	IV ;
akiitsorfig	TVschwa ;
akiitsor	IV ;
akiitsorsi	IV ;
akiitsortip	TV ;
aki	IV ;
akikigissaa	IV ;
akikig	TVschwa ;
akikilliartor	IV ;
akikilliartortip	TV ;
akikilliartuinnar	IV ;
akikilli	IV ;
akikilliler	TV ;
akikilliler	XTiXmorf ;
akikillilii	IV ;
akikilliliisar	IV ;
akikillisip	TV ;
akikillissutig	TVschwa ;
akikillissutaa	IV ;
akikillissutaasinnaa	IV ;
akikilli	TV ;
akikinaar	TV ;
akikinaavip	TV ;
akikip	XItsXmorf ;
akikitsunnguu	IV ;
akileeqataa	IV ;
akileeqataassagaluar	IV ;
akileereer	IV ;
akileqqup	TV ;
akileqqaaqqugaluar	TV ;
akileqqaaqqu	TV ;
akileqqaar	TV ;
akilerar	IV ;
akilerar	TV ;
akilereer	IV ;
akilereer	TV ;
akilereer	XTiXmorf ;
akileriip	XIPXmorf ;
akiler	IV ;
akilersinnaagaluar	IV ;
akilersinnaagaluar	TV ;
akilersinnaa	IV ;
akilersinnaa	TV ;
akilersip	IV ;
akilersip	TV ;
akilersorneqarsinnaagaluar	IV ;
akilersorneqarsinnaa	IV ;
akilersor	TV ;
akilersugaqarpallaar	IV ;
akilersugassarsi	IV ;
akilersui	IV ;
akiler	TV ;
akiler	TVschwa ;
akiler	XIiXmorf ;
akiler	XTiXmorf ;
akileraa	IV ;
akileraar	IV ;
akileraartartuu	IV ;
akileraartussaatitaa	IV ;
akiligassalerujussuu	IV ;
akiligassanngor	IV ;
akiligassanngortip	TV ;
akiligassaqaraluar	IV ;
akiligassaqarfig	TVschwa ;
akiligassaqarler	XIiXmorf ;
akiligassaqarpallaar	IV ;
akiligassarsi	IV ;
akiligassarsisip	TV ;
akiligassarsisitsi	IV ;
akilii	IV ;
akiliisinnaagaluar	IV ;
akiliisinnaa	IV ;
akiliisinnaajunnaar	IV ;
akiliisinnaajunnaarnerar	TV ;
akiliisip	TV ;
akiliisitsiniartartuu	IV ;
akiliisitaa	IV ;
akiliisitaaqinuugut	K ;
akiliisitaaqinuunga	K ;
akiliissagaluar	IV ;
akiliisussaagaluar	IV ;
akiliisussaa	IV ;
akiliisussaatitaa	IV ;
akilinermukar	IV ;
akiliniliar	IV ;
akilior	IV ;
akilior	TV ;
akiliup	XTuteXmorf ;
akiliussi	IV ;
akiliutig	TVschwa ;
akiliutaa	IV ;
akillorippallaar	IV ;
akillorip	XIiXmorf ;
akillorissaar	IV ;
akilluar	IV ;
akilluar	TV ;
akilup	IV ;
akilutsitsi	IV ;
akilutsitsisar	IV ;
akima	IV ;
akimaneru	IV ;
akimavallaar	IV ;
akimiu	IV ;
akimmakkaluttuinnar	IV ;
akimmap	IV ;
akimmiffig	TVschwa ;
akimmigar	IV ;
akimmigarnar	IV ;
akimmioq	K ;
akimmip	IV ;
akimmisar	IV ;
akimmisartip	TV ;
akimmisartitsi	IV ;
akimmisip	TV ;
akimmisaartip	TV ;
akimmisaartitsi	IV ;
akimmaatig	TVschwa ;
akimoor	IV ;
akimorluinnar	TV ;
akimor	TV ;
akimui	IV ;
akimuip	TV ;
akinasuar	IV ;
akinasuar	TV ;
akineqarumaar	IV ;
akineqarumaarsor	IVschwa ;
akinger	IV ;
akingersor	TV ;
akingersui	IV ;
akinger	TV ;
akinger	XTiXmorf ;
akingii	IV ;
akingip	XItsXmorf ;
akinialerituallaar	IV ;
akinialeritu	IV ;
akiniukkiartor	TV ;
akiniup	XTuteXmorf ;
akiniussi	IV ;
akiniutig	TVschwa ;
akiniutaa	IV ;
akiniaagajup	IV ;
akiniaa	IV ;
akiniaaleritu	IV ;
akinnap	TV ;
akinnassi	IV ;
akinnassissutig	TVschwa ;
akinnassutig	TVschwa ;
akioriip	XIPXmorf ;
akior	IV ;
akiorluaraluar	TV ;
akiorluar	TV ;
akiorsar	TVschwa ;
akiortuar	IV ;
akiortuar	TV ;
akior	TV ;
akip	TV ;
akisar	IV ;
akisartartip	TV ;
akisartor	IV ;
akisartortip	TV ;
akisartortuu	IV ;
akisig	TVschwa ;
akisi	IV ;
akisisar	IV ;
akisitaar	IV ;
akisoorsuugaluar	IV ;
akisoorsuu	IV ;
akissamaaraluar	IV ;
akissamaaraluar	TV ;
akissamaar	TV ;
akissap	TV ;
akissaqanngivip	XIiXmorf ;
akissaqaraluar	IV ;
akissaqartinngivip	TV ;
akissaqartip	IV ;
akissaqartip	TV ;
akissarissaar	IV ;
akissarsiaqarluar	IV ;
akissarsiaqartip	TV ;
akissarsiar	TVschwa ;
akissarsi	IV ;
akissarsior	IV ;
akissarsiorluar	IV ;
akissarsip	IV ;
akissarsip	TV ;
akissarsissutig	TVschwa ;
akissarsiutig	TVschwa ;
akissup	TV ;
akissup	XTuteXmorf ;
akissutig	TVschwa ;
akissutissaaleqi	IV ;
akissutissaaleqissup	TV ;
akissutissaarup	XIuteXmorf ;
akissutissaarutiinnar	IV ;
akissutissaarutivip	XIiXmorf ;
akissutissaarutsip	TV ;
akissaajaatigiinnar	TV ;
akissaajaatig	TVschwa ;
akissaarup	XIuteXmorf ;
akissaarup	XTuteXmorf ;
akissaarutivip	XIiXmorf ;
akissaaruttoor	IV ;
akissaaser	XTiXmorf ;
akissaatikilli	IV ;
akissaatikillior	IV ;
akissaatituutig	TVschwa ;
akisua	IV ;
akisuallarip	XIiXmorf ;
akisuallaanngikkaluar	IV ;
akisuallaar	IV ;
akisuallaartip	TV ;
akisuar	IV ;
akisuartip	TV ;
akisuatip	TV ;
akisugigaluar	TV ;
akisugissaa	IV ;
akisugissaa	TV ;
akisug	IVschwa ;
akisug	TVschwa ;
akisugup	IV ;
akisu	IV ;
akisukulup	IV ;
akisuneru	IV ;
akisunaangaar	TV ;
akisunaar	TV ;
akisup	IV ;
akisussaa	IV ;
akisussaassuseqarluar	IV ;
akisussaassuseqartitaa	IV ;
akisussaasuu	IV ;
akisaar	TV ;
akisaarup	IV ;
akisaasalior	IV ;
akisaataar	IV ;
akitser	IV ;
akitsi	IV ;
akitsior	IV ;
akitsior	TV ;
akitsisip	TV ;
akitsiup	TV ;
akitsoraluttuinnar	IV ;
akitsor	IV ;
akitsorteri	IV ;
akitsorterisitsi	IV ;
akitsorter	IV ;
akitsorterussi	IV ;
akitsorterussisuu	IV ;
akitsortip	TV ;
akitsor	TV ;
akitsui	IV ;
akitsuusersui	IV ;
akitsuuser	XTiXmorf ;
aki	TV ;
akiui	IV ;
akiuisar	IV ;
akiumaar	IV ;
akiumaar	TV ;
akiusior	IV ;
akiutaar	TV ;
akiuukkumaller	XIiXmorf ;
akiuukkunnaarallar	IV ;
akiuukkunnaar	IV ;
akiuukkunnaassutig	TVschwa ;
akiuulluaraluar	IV ;
akiuulluar	IV ;
akiuup	IV ;
akiuussutig	TVschwa ;
akiuussutissalersui	IV ;
akiuussutissaqarluar	IV ;
akiuussutissaarup	IV ;
akiuuteqatigiip	XIPXmorf ;
akiuutipalaar	IV ;
akiuutipalaarsinnaa	IV ;
akiuutiusaar	IV ;
akkag	TVschwa ;
akkequser	TV ;
akkequtaa	IV ;
akkersaraap	IV ;
akkersip	IV ;
akker	TV ;
akker	XTiXmorf ;
akkii	IV ;
akkip	XItsXmorf ;
akkisip	TV ;
akkisissaarup	IV ;
akkisissaarutsip	TV ;
akkittartuler	TV ;
akkiuser	TV ;
akkiutaarup	IV ;
akkujoor	IV ;
akkup	XIPXmorf ;
akkup	XTPXmorf ;
akkussaa	IV ;
akoori	IV ;
akoorisar	IV ;
akoor	IV ;
akoorivallaar	IV ;
akoorneqarsinnaa	IV ;
akoor	TV ;
akoorutaa	IV ;
akorloqqua	TV ;
akorloqqup	TV ;
akorloqqutsi	IV ;
akorlorup	TV ;
akorloruup	TV ;
akorlup	IV ;
akorngusersuiinnar	IV ;
akorngusersui	IV ;
akorngusersuivallaar	IV ;
akornguser	TV ;
akornguser	XTiXmorf ;
akorngusii	IV ;
akorngutigiinnar	TV ;
akorngutig	TVschwa ;
akornu	IV ;
akornup	TV ;
akornusersor	TV ;
akornusersuiinnar	IV ;
akornusersui	IV ;
akornuser	XTiXmorf ;
akornusii	IV ;
akornutig	TVschwa ;
akornutissaqartip	IV ;
akornutissaqartip	TV ;
akornut	TVschwa ;
akornutaa	IV ;
akornutaarup	IV ;
akorsi	IV ;
akortammeer	IV ;
akorter	IV ;
akortu	IV ;
akor	TV ;
akortaa	IV ;
akuattu	IV ;
akueqqusersor	TV ;
akueqqutigiip	XIPXmorf ;
akueqqutig	TVschwa ;
akueqqutaa	IV ;
akuereqatigiip	XIPXmorf ;
akueriip	XIPXmorf ;
akueri	IV ;
akuerineqarsinnaagaluar	IV ;
akuerineqarsinnaa	IV ;
akuerissutig	TVschwa ;
akuerisaa	IV ;
akueriuma	IV ;
akueriuma	TV ;
akuersi	IV ;
akuersissutig	TVschwa ;
akuersor	TV ;
akuersui	IV ;
akuersunnginngaar	IV ;
akuersunnginngaar	TV ;
akuersaarfig	TVschwa ;
akuersaar	IV ;
akuersaar	TV ;
akuer	TVschwa ;
akugiip	XIPXmorf ;
akugiissip	TV ;
akuiagaa	IV ;
akuiar	TV ;
akuilisaarser	IV ;
akuilitser	IV ;
akuilitsi	IV ;
akuiaa	IV ;
akukinneru	IV ;
akukip	XItsXmorf ;
akulammip	IV ;
akulammip	TV ;
akulanger	IV ;
akulasser	XTiXmorf ;
akuleriip	XIPXmorf ;
akuleriissip	TV ;
akuleriissitsi	IV ;
akulersor	TV ;
akulersuup	IV ;
akulerup	IV ;
akulerup	TV ;
akulerutip	TV ;
akulerutitsi	IV ;
akulerutsi	IV ;
akuler	XTiXmorf ;
akuleraar	IV ;
akuliakip	XItsXmorf ;
akuliarmii	IV ;
akuliarmip	TV ;
akulikilli	IV ;
akulikillisip	TV ;
akulikip	XItsXmorf ;
akulikisua	IV ;
akulikisuar	IV ;
akulikitsoor	IV ;
akulissior	IV ;
akuliuffig	TVschwa ;
akuliunneqarsinnaa	IV ;
akuliup	IV ;
akuliup	TV ;
akuliussi	IV ;
akuliuttussaatitaa	IV ;
akulivip	TV ;
akullap	IV ;
akullarteri	IV ;
akullarter	IV ;
akullar	XIPXmorf ;
akullatser	XTPXmorf ;
akullattaari	IV ;
akullattaarisar	IV ;
akullattaar	IVschwa ;
akullattaar	TV ;
akullernukar	IV ;
akullersar	TVschwa ;
akullersor	TV ;
akuller	XTiXmorf ;
akullii	IV ;
akulliu	IV ;
akulloqqua	XTPXmorf ;
akulloqqup	TV ;
akulloqqutsi	IV ;
akullorup	TV ;
akulloruup	TV ;
akulloruussi	IV ;
akulaajar	IV ;
akulaallup	IV ;
akulaaviar	IV ;
akummip	TV ;
akunnagiler	TV ;
akunnag	TVschwa ;
akunnakusoor	IV ;
akunnakusoortip	TV ;
akunnap	IV ;
akunnassi	IV ;
akunnattoor	IV ;
akunnattoortip	TV ;
akunnattoor	TV ;
akunnattuuataar	IV ;
akunnequser	XTiXmorf ;
akunnequtsersui	IV ;
akunnequtser	XTiXmorf ;
akunnequtaa	IV ;
akunnermiliup	IV ;
akunnermiliup	TV ;
akunnermiliuttuu	IV ;
akunnermip	TV ;
akunnermiu	IV ;
akunnermiuler	XTPXmorf ;
akunnermiulii	IV ;
akunnermiuliup	TV ;
akunnerup	TV ;
akunneraar	XIPXmorf ;
akunniffig	TVschwa ;
akunnikip	XItsXmorf ;
akunnilersor	XTPXmorf ;
akunniler	XTiXmorf ;
akunnisip	TV ;
akunnaalli	IV ;
akunnaallisar	TV ;
akunnaalli	TV ;
akunnaanukar	IV ;
akunnaap	XItsXmorf ;
akusi	IV ;
akusiorneqarsinnaa	IV ;
akusior	TV ;
akusiui	IV ;
akusseri	IV ;
akussigaasar	IV ;
akussigaasar	TV ;
akussip	TV ;
akussip	XIiXmorf ;
akussaa	IV ;
akusaa	IV ;
akutassuu	IV ;
akutsoqaler	XIiXmorf ;
akutsunip	IV ;
akuttarip	XIiXmorf ;
akuttatsip	IV ;
akuttoqatigiip	XIPXmorf ;
akuttoqatigiissaari	IV ;
akuttoqatigiissaar	XIPXmorf ;
akuttoqatigiissaar	XTPXmorf ;
akuttu	IV ;
akuttusi	IV ;
akuttusoorsuu	IV ;
akuttutsip	IV ;
akuttutsivip	XIiXmorf ;
aku	TV ;
akutaa	IV ;
akutaatig	IVschwa ;
akutaatig	TVschwa ;
akuugaa	IV ;
akuui	IV ;
akuuisar	IV ;
akaarinngivip	XTiXmorf ;
akaarinnip	IV ;
akaar	IVschwa ;
akaarnar	IV ;
akaarnaappallaar	IV ;
akaarnaap	XItsXmorf ;
akaar	TVschwa ;
alakkariartor	TV ;
alakkariar	TV ;
alakkar	IV ;
alakkarteri	IV ;
alakkarter	IV ;
alakkarter	TV ;
alakkar	TV ;
alakkaama	IV ;
alakkaama	TV ;
alakkaap	IV ;
alanga	IV ;
alanga	TV ;
alangaannar	IV ;
alangaannar	TV ;
alanngerar	IV ;
alannger	IV ;
alanngeraar	IV ;
alanngeraar	TV ;
alanngiala	IV ;
alanngilertor	IV ;
alanngilertor	TV ;
alanngip	IV ;
alanngip	TV ;
alanngiser	IV ;
alanngorip	XIiXmorf ;
alanngortarsior	IV ;
alanngortaarup	IV ;
alanngortaasalersor	TV ;
alanngunip	IV ;
alanngaallaqqip	XIiXmorf ;
alanngaallaqqissivip	XIiXmorf ;
alanngaallaqqissuu	IV ;
alanngaar	IV ;
alanngaarsinnaa	IV ;
alanngaarsinnaa	TV ;
alanngaartip	TV ;
alanngaartitsi	IV ;
alanngaartitaa	IV ;
alanngaar	TV ;
alanngaartaannar	IV ;
alanngaartaannar	TV ;
alapernaakkajup	IV ;
alapernaap	IV ;
alapernaappallaar	IV ;
alapernaap	TV ;
alapernaap	XItsXmorf ;
alapernaarsor	TV ;
alapernaarsui	IV ;
alapernaarsuisuu	IV ;
alapernaaser	IV ;
alapernaaser	TV ;
alapernaatsuu	IV ;
alar	IV ;
alarter	TV ;
alarter	XTiXmorf ;
alar	TV ;
alartaa	IV ;
alartaaser	IV ;
alartaaser	TV ;
alartaasii	IV ;
alassersui	IV ;
alasser	XTiXmorf ;
alatariaqanngivip	XIiXmorf ;
alataa	IV ;
aleerser	IV ;
aleqar	TVschwa ;
aleqaar	TVschwa ;
alersersualer	XIiXmorf ;
alersig	TVschwa ;
alersilior	IV ;
alersaannaa	IV ;
alersaarup	IV ;
alersaarussi	TV ;
aliag	TVschwa ;
alianaq	K ;
alianaraluar	IV ;
alianar	IV ;
alianni	IV ;
aliannaar	IV ;
aliannaarnar	IV ;
aliannaarsaariar	IV ;
aliannaarsaar	IV ;
aliannaartip	TV ;
aliannaartitsi	IV ;
aliannaarutig	TVschwa ;
alianaag	TVschwa ;
alianaak	K ;
alianaalli	IV ;
alianaallivip	XIiXmorf ;
alianaalluinnar	IV ;
alianaap	XItsXmorf ;
alianaarsaariar	IV ;
alianaarsaar	IV ;
alianaassi	IV ;
alianaassivip	XIiXmorf ;
aliartor	IV ;
aliartor	TV ;
aliasungaar	IV ;
aliasup	IV ;
aliasuppalup	IV ;
aliasuusaar	IV ;
aliasuutigisariaqanngivip	XIiXmorf ;
aliasuutig	TVschwa ;
aliasuutaa	IV ;
aliasaar	TV ;
aliatsangaar	IV ;
aliatsannar	IV ;
aliatsap	IV ;
aliatsassaar	TV ;
aliatsatsip	TV ;
aliatsatsiti	IV ;
aliatsatsitipp	IV ;
aliatsatsitip	TV ;
aliatsaap	TV ;
aliatsaatig	IVschwa ;
aliatsaatig	TVschwa ;
alig	TVschwa ;
aliikkusersor	TV ;
aliikkusersui	IV ;
aliikkusersuisartuu	IV ;
aliikkusiarfig	TVschwa ;
aliikkusiar	IV ;
aliikkusiaa	IV ;
aliikkutariinnar	TV ;
aliikkutariip	XIPXmorf ;
aliikkutarilluar	TV ;
aliikkutar	TVschwa ;
aliikkutassarsior	IV ;
aliikkutassiar	TVschwa ;
aliikkutassior	IV ;
aliikkutassiortuu	IV ;
aliikkutassior	TV ;
aliikkutaa	IV ;
aliikkutaalluar	IV ;
aliikkutaalluarsinnaa	IV ;
aliima	IV ;
ali	IV ;
alikkaler	XIiXmorf ;
alikkar	IV ;
alilior	IV ;
alilior	TV ;
alima	IV ;
alimasiar	IV ;
alimasig	TVschwa ;
alimasip	XIiXmorf ;
alinnar	IV ;
alinnar	TVschwa ;
aliortor	IV ;
aliortua	IV ;
aliortuarnilersaar	IV ;
aliortukkersaar	IV ;
alip	IV ;
alip	TV ;
alisinngor	IV ;
alisip	IV ;
alisip	TV ;
alissi	IV ;
alissior	IV ;
alitser	XTiXmorf ;
alitsiup	TV ;
alittoor	IV ;
alittor	IV ;
alittor	TV ;
alittui	IV ;
alittui	TV ;
alittuup	IV ;
alittuussi	IV ;
ali	TV ;
allaffigeqatigiip	XIPXmorf ;
allaffig	TVschwa ;
allaffimmiuu	IV ;
allaffiu	IV ;
allagarser	XTiXmorf ;
allagarsiffig	TVschwa ;
allagarsii	IV ;
allagarsi	IV ;
allagarsivig	TVschwa ;
allagartalii	IV ;
allagartaliup	TV ;
allagar	TVschwa ;
allaga	TVschwa ;
allaginnip	IV ;
allagissaar	IV ;
allajup	IV ;
allakip	XItsXmorf ;
allakkajaa	IV ;
allakkasuar	IV ;
allakkisar	IV ;
allakkoor	IV ;
allakkoor	TV ;
allakkuminar	IV ;
allakkusup	IV ;
allaleratallar	IV ;
allalersor	TV ;
allalimaar	IV ;
allallaqqip	XIiXmorf ;
allanar	IV ;
allanarsi	IV ;
allanar	TVschwa ;
allaneqanngivip	XIiXmorf ;
allanner	IV ;
allannerlup	IV ;
allannerluppallaar	IV ;
allannerlup	TV ;
allanner	XTiXmorf ;
allanngorar	IV ;
allanngor	IV ;
allanngortip	TV ;
allanngortitassaa	IV ;
allanngortitassaanngivip	XIiXmorf ;
allanngortitsiuma	IV ;
allanngortitsiumanngivip	XIiXmorf ;
allanngortivip	TV ;
allanngor	TV ;
allannguja	IV ;
allanngujavallaar	IV ;
allanngujuip	XItsXmorf ;
allanngujuitsuu	IV ;
allanngutsaaliugaa	IV ;
allannguuteqanngivip	XIiXmorf ;
allannii	IV ;
allapalaari	IV ;
allapalaarisar	IV ;
allapalaar	TV ;
allapap	IV ;
allap	IV ;
allap	TV ;
allaqqip	TV ;
allaqqissaar	IV ;
allaqqissaar	TV ;
allaqqunnaveer	IV ;
allaqqunnaveerunar	IV ;
allaqqup	IV ;
allar	IV ;
allarneerup	IV ;
allarnerasaar	IV ;
allarteri	IV ;
allarter	IV ;
allarter	TV ;
allasior	IV ;
allassar	IV ;
allassinnaa	IV ;
allatoor	IV ;
allator	IV ;
allatsip	IV ;
allatsitsi	IV ;
allattariarsor	IV ;
allattor	TV ;
allattui	IV ;
allattuisar	IV ;
allattaa	IV ;
allattaannar	IV ;
allattaaser	TVschwa ;
allequtar	TVschwa ;
allequtser	IV ;
allequtsersor	IV ;
allequtsersor	TV ;
allequtsersui	IV ;
allequtser	TV ;
allequtser	XTiXmorf ;
allequtaarup	IV ;
allerpalaar	IV ;
allerpaa	IV ;
allerpaanngor	TV ;
allerula	IV ;
allerulaar	IV ;
allerup	TV ;
allerutig	TVschwa ;
aller	XIiXmorf ;
aller	XTiXmorf ;
alliakip	XItsXmorf ;
alliallap	IV ;
alliallap	TV ;
alliar	IV ;
alliartor	IV ;
alliartorluar	IV ;
alliartuaar	IV ;
alligaluttuinnar	IV ;
alligaluttuinnar	TV ;
alligarnip	IV ;
alligartor	TV ;
alligar	TV ;
alligaarser	IV ;
alli	IV ;
allikarfig	TVschwa ;
allikar	IV ;
allikartip	TV ;
allikarup	IV ;
allikaap	IV ;
allinilup	IV ;
allinngortip	TV ;
allinnior	IV ;
allinniortip	TV ;
allior	IV ;
allior	TV ;
alliortaannar	IV ;
alliorup	IV ;
alliorup	TV ;
allipaqutser	IV ;
allipaqutser	XIiXmorf ;
allipaqutser	XTiXmorf ;
allip	IV ;
allisarfig	TVschwa ;
allisar	IV ;
allisar	TV ;
alliser	IV ;
allisiip	XItsXmorf ;
allisiitsuu	IV ;
allisip	TV ;
allisitsi	IV ;
allisitsiuser	IV ;
allisoor	IV ;
allisser	IV ;
allissersor	IV ;
allissersor	TV ;
allissiup	TV ;
allisaa	IV ;
allitsii	TV ;
allittartuler	TV ;
alli	TV ;
alliu	IV ;
alliumaarnertu	IV ;
alliutip	TV ;
alloraqatigiip	XIPXmorf ;
alloraqatig	TVschwa ;
allorar	IV ;
allorar	TV ;
allorassaar	IV ;
alloriar	IV ;
alloriarnertu	IV ;
alloriarnertuneqqisaap	IV ;
allor	IV ;
allorneqqortu	IV ;
allornertusaar	IV ;
allornikip	XItsXmorf ;
allor	TV ;
alloraa	IV ;
allualior	IV ;
alluar	IV ;
alluar	TV ;
alluiar	IV ;
alluitsumukar	IV ;
allukaar	IV ;
allulior	IV ;
allunassi	IV ;
allunassior	IV ;
allungiar	IV ;
allungiartorfilior	IV ;
allunaalior	IV ;
allunaaqattaar	IV ;
allunaariaqattaar	IV ;
allunaasaleri	IV ;
allunaaseri	IV ;
allunaasior	IV ;
allup	IV ;
allusior	IV ;
allusiortip	IV ;
allussi	IV ;
alluuma	IV ;
allaa	IV ;
allaama	IV ;
allaanga	IV ;
allaangasoor	IV ;
allaannagarpasip	XIiXmorf ;
allaap	IV ;
allaaqqik	K ;
allaaqqip	XIiXmorf ;
allaaqqissi	IV ;
allaaqqissorsuu	IV ;
allaar	TV ;
allaasior	IV ;
allaassutig	TVschwa ;
allaasaar	IV ;
allaatiginneqarsinnaa	IV ;
allaatiginnip	IV ;
allaatiginnittuu	IV ;
allaatig	TVschwa ;
allaatip	TV ;
allaattoor	IV ;
allaattor	IV ;
allaattor	TV ;
allaa	TV ;
aloquser	IV ;
aloquser	TV ;
aloquser	XIiXmorf ;
aloquser	XTiXmorf ;
aloqusior	IV ;
aloqutser	TV ;
aloqutser	XIiXmorf ;
aloqutser	XTiXmorf ;
aloqutsior	IV ;
alorartaar	IV ;
alorsi	IV ;
alorsinar	IV ;
aluerulluinnar	IV ;
aluerup	IV ;
alueruttoor	IV ;
alugaa	IV ;
aluiler	XIiXmorf ;
alukumiaa	IV ;
alumerar	IV ;
alumerar	TV ;
alunngu	IV ;
alunngujuinaar	IV ;
alunngunar	IV ;
alupissuinnar	IV ;
alup	IV ;
alup	TV ;
alupaarajup	IV ;
alupaar	IV ;
alussar	IV ;
alussor	IV ;
alussor	TV ;
alussup	IV ;
alussaar	IV ;
alussaasior	IV ;
alussaasior	TV ;
alussaasiup	TV ;
alussaatiliuup	TV ;
alutornar	IV ;
alutornarluinnar	IV ;
alutornarsaar	TV ;
alutornavip	XIiXmorf ;
alutorsar	IV ;
alutorsartip	TV ;
alutorsartivissor	TV ;
alutorsaa	IV ;
alutorsaatig	TVschwa ;
alutorsaataa	IV ;
alutorsaataavip	XIiXmorf ;
alutorsaataavissor	IV ;
alutor	TVschwa ;
alutsip	TV ;
aluttor	IV ;
aluttor	TV ;
aluttui	IV ;
aluttuisaqinak	K ;
aluttuisaqinasi	K ;
aluttuisar	IV ;
alaakip	XItsXmorf ;
alaangajap	IV ;
alaangajavip	XIiXmorf ;
alaanngar	IV ;
alaaqqajar	IV ;
alaaqqajavip	XTiXmorf ;
alaasungar	TV ;
alaatsinaakkuma	TV ;
alaatsinaap	IV ;
alaatsinaap	TV ;
alaatsinaap	XItsXmorf ;
amakker	IV ;
amakker	TV ;
amakkissaatari	IV ;
amakkiup	XTuteXmorf ;
amakkiussi	IV ;
amannar	IV ;
amannaap	XItsXmorf ;
amartip	IV ;
amar	TV ;
amartaa	IV ;
amaruerup	IV ;
amaruerutivip	IV ;
amaruerutivip	XIiXmorf ;
amarunip	IV ;
ambassadøriu	IV ;
ameersalaar	IV ;
ameersalaarnar	IV ;
ameersi	IV ;
ameerup	IV ;
ameeruttoor	IV ;
ameer	XIiXmorf ;
ameer	XTiXmorf ;
ameqqa	XIPXmorf ;
ameqqaap	XTuteXmorf ;
amequsuler	XIiXmorf ;
amequsup	IV ;
amequsutsip	IV ;
ameralimmukar	IV ;
amerikamukar	IV ;
amer	IV ;
amerlakulup	IV ;
amerlaneru	IV ;
amerlanerussuteqar	XIPXmorf ;
amerlaneraar	IV ;
amerlanaari	IV ;
amerlanaar	TV ;
amerlaqaser	XTPXmorf ;
amerlaqatigiilersip	TV ;
amerlasoorparujussuu	XIPXmorf ;
amerlasoor	TV ;
amerlasuu	XIPXmorf ;
amerla	XIPXmorf ;
amerliinaar	IV ;
amerli	IV ;
amerlisar	XTPXmorf ;
amerlisip	TV ;
amerlissutaa	IV ;
amerlisaa	IV ;
amerli	XTPXmorf ;
amerlujoraar	IV ;
amerluup	TV ;
amerlaalup	IV ;
amerlaaluttukasiup	IV ;
amernerissaar	IV ;
amersi	IV ;
amersor	IV ;
amer	TV ;
amerualer	XIiXmorf ;
amiakkuerup	IV ;
amiakkusi	IV ;
amiakku	TV ;
amiakkuu	IV ;
amiakkuup	TV ;
amigar	IV ;
amigartip	TV ;
amigartoor	IV ;
amigartoorutig	TVschwa ;
amigar	TVschwa ;
amigilaaginnar	TV ;
amigilaar	TV ;
amigisoor	TV ;
amig	TVschwa ;
amigaateqartip	IV ;
amigaateqartip	TV ;
amigaatig	TVschwa ;
amigaataa	IV ;
amiiagaa	IV ;
amiialikap	IV ;
amiialitser	IV ;
amiialitser	XTiXmorf ;
amiiar	IV ;
amiiar	TV ;
amii	IV ;
amiilaammi	IV ;
amiilaammissutig	TVschwa ;
amiilaammisaar	IV ;
amiilaammisaarnar	IV ;
amiilaar	IV ;
amiilaarnar	IV ;
amiilaar	TVschwa ;
amiimeer	IV ;
amiisar	IV ;
amiisissaarup	IV ;
amikkakuu	IV ;
amikkip	TV ;
amikkip	XItsXmorf ;
amikkisaar	IV ;
amikkisaartip	TV ;
amikkittoor	IV ;
amileraajar	IV ;
amiliallap	IV ;
amiliallap	TV ;
amiliartor	IV ;
amili	IV ;
amilima	IV ;
amilima	TV ;
amilisar	TV ;
amili	TV ;
amiliup	TV ;
amiliussor	XTPXmorf ;
amiluallag	TVschwa ;
amiluallap	IV ;
amiluallaannar	IV ;
aminip	IV ;
aminneru	IV ;
amippallaar	IV ;
amip	XItsXmorf ;
amissar	TV ;
amissior	IV ;
amissior	TV ;
amitsuali	IV ;
amitsussi	TV ;
amiutigissaar	IV ;
amma	IV ;
ammala	IV ;
ammalatarsior	IV ;
ammallorip	XIiXmorf ;
ammallorissar	TV ;
ammalluarip	XIiXmorf ;
ammaloqisaalior	IV ;
ammaloqisaartor	IV ;
ammaloqisaator	IV ;
ammaloqqissaar	IV ;
ammalor	IV ;
ammalorsar	TV ;
ammalortulior	IV ;
ammaqqip	IV ;
ammaqqip	TV ;
ammaqqip	XIiXmorf ;
ammaqqorluar	TV ;
ammaqqor	TV ;
ammaqquup	IV ;
ammaqquup	TV ;
ammar	IV ;
ammarsar	TV ;
ammarsaatig	TVschwa ;
ammartagalior	IV ;
ammarteri	IV ;
ammarter	IV ;
ammarter	TV ;
ammar	TV ;
ammaruttoor	IV ;
ammasoor	IV ;
ammassalimmukar	IV ;
ammassiar	IV ;
ammassi	IV ;
ammassisar	IV ;
Ammassivimmukar	IV ;
ammassivimmukar	IV ;
ammassivinnaaminnukar	IV ;
ammassivinnaaminukar	IV ;
ammassivinnaar	TVschwa ;
ammeri	IV ;
ammerillaqqip	XIiXmorf ;
ammerisar	IV ;
ammiameer	IV ;
ammii	IV ;
ammii	TV ;
ammior	IV ;
ammiortuu	IV ;
ammior	TV ;
ammip	IV ;
ammissar	TV ;
ammiup	TV ;
ammiussor	XTPXmorf ;
ammorluinnaar	IV ;
ammorsor	IV ;
ammukajaar	IV ;
ammukar	IV ;
ammukaa	IV ;
ammukaap	TV ;
ammukaap	XTuteXmorf ;
ammukaar	IV ;
ammukaassi	IV ;
ammukaassivig	TVschwa ;
ammup	TV ;
ammuser	TV ;
ammusiup	TV ;
ammussi	IV ;
ammussor	XTPXmorf ;
ammaa	IV ;
ammaalup	IV ;
ammaaluttuinnaa	IV ;
ammaanersior	IV ;
ammaa	TV ;
amoorfiler	TV ;
amoor	IV ;
amoorneqareer	IV ;
amoortip	IV ;
amoor	TV ;
amoortaa	IV ;
amorap	TV ;
amorassaar	TV ;
amoratsip	TV ;
amorrap	IV ;
amorrarip	XIiXmorf ;
amorraser	IV ;
amorraser	TV ;
amoraa	IV ;
amuar	IV ;
amuarrap	IV ;
amuar	TV ;
amu	IV ;
amuniup	IV ;
amusariarsor	IV ;
amusariartaar	IV ;
amusi	IV ;
amusoor	IV ;
amusoor	TV ;
amussip	IV ;
amussip	TV ;
amussittoor	IV ;
amussittoor	TV ;
amutip	IV ;
amutsisilior	IV ;
amu	TV ;
amuullaja	IV ;
amuullarter	TV ;
amuullar	TV ;
amuaannar	IV ;
amuaannar	TV ;
amaamap	IV ;
amaar	IV ;
amaartip	IV ;
amaartuarrap	IV ;
amaar	TV ;
amaaser	IV ;
amaasisaar	IV ;
amaatitaar	IV ;
anagguffig	TVschwa ;
anaggup	XItX ;
anaggutaar	IV ;
anajorap	IV ;
ananassitor	IV ;
anarianip	IV ;
anariartor	IV ;
anar	IV ;
anariaarup	IV ;
anarnar	IV ;
anarnartor	IV ;
anarnartortortip	TV ;
anarni	IV ;
anarnip	IV ;
anarrap	IV ;
anarrattorsuup	IV ;
anarsar	TV ;
anarsaasior	IV ;
anarsaatitor	IV ;
anarsaatitortip	TV ;
anartarfileri	IV ;
anar	TV ;
anarusukkaluar	IV ;
anarusuler	XIiXmorf ;
anarusunnar	IV ;
anarusup	IV ;
anarusuutig	TVschwa ;
aneerasaar	IV ;
aneerasaartarfilior	IV ;
aneerasaarup	XTuteXmorf ;
aneerni	IV ;
aneersip	TV ;
aneersitsi	IV ;
aneersuar	IV ;
aneersuarniar	IV ;
aneersuarrap	XIPXmorf ;
aneerussi	IV ;
aneer	XIiXmorf ;
aneqattaar	IV ;
aneqattaarpallaar	IV ;
aneqqu	IV ;
aneqqu	TV ;
aneqqaanniuup	XIPXmorf ;
anerlaa	IV ;
anerlaaju	IV ;
anerneerup	XIuteXmorf ;
anernerissaasior	IV ;
anernikisaar	IV ;
anerninger	IV ;
anerningiap	IV ;
anernissaarup	IV ;
anerpallap	IV ;
anerpallariar	IV ;
anersar	TV ;
anersaaleri	IV ;
anersaami	IV ;
anersaamissutig	TVschwa ;
anersaammi	IV ;
anersaar	IV ;
anersaarsior	IV ;
anersaartor	IV ;
anersaartuutig	TVschwa ;
anersaarulup	IV ;
anersaaruluutig	TVschwa ;
anerteqi	IV ;
anerteqip	IV ;
anerteqisaar	IV ;
anerteqisaarutig	TVschwa ;
anerteri	IV ;
anertikkar	IV ;
anertikkaatig	TVschwa ;
anga	IV ;
angajoqqaa	IV ;
angajoqqaaju	IV ;
angajoqqaarup	IV ;
angajoqqaatserfig	TVschwa ;
angajoqqaatser	IV ;
angajoqqaaverup	IV ;
angajornoriip	XIPXmorf ;
angajullequtig	TVschwa ;
angajullerpaaju	IV ;
angajullersar	TVschwa ;
angajullersaa	IV ;
angajulliu	IV ;
angakkorsuu	IV ;
angakkuar	IV ;
angakkuarsaar	IV ;
angakkuar	TV ;
angakkuersaar	IV ;
angakkulersaar	IV ;
angakkussar	IV ;
angakkutsip	IV ;
angakkuusiar	IV ;
angalaffigisar	TV ;
angalaffig	TVschwa ;
angala	IV ;
angalalersaaraluar	IV ;
angalalersaar	IV ;
angalanilersaar	IV ;
angalaqatig	TVschwa ;
angalaqatiigiip	XIPXmorf ;
angalassamaaraluar	IV ;
angalassamaar	IV ;
angalatoorsuu	IV ;
angallanneqarsinnaa	IV ;
angallap	IV ;
angallap	TV ;
angallarlup	IV ;
angallarlussigaluttuinnar	IV ;
angallarlussi	IV ;
angallarlussivip	IV ;
angallarlutsig	TVschwa ;
angallarlutsip	IV ;
angallarlutsivip	XIiXmorf ;
angallassi	IV ;
angallassisar	IV ;
angallatigip	IV ;
angallatigip	XIiXmorf ;
angallatigissaar	IV ;
angallatig	TVschwa ;
angallatikinaar	TV ;
angallatitaar	IV ;
angallatitaartip	TV ;
angallattagaa	IV ;
angallataa	IV ;
angallavigisar	TV ;
angallavig	TVschwa ;
angallavikinaar	TV ;
angallavikip	XItsXmorf ;
angalaannar	IV ;
angalaap	TV ;
angalaar	IV ;
angalaartuar	IV ;
angalaartaannar	IV ;
angalaarumatuip	XIiXmorf ;
angalaarumatu	IV ;
angarlisar	IV ;
angarlisaatig	TVschwa ;
angassaar	IV ;
angassaartip	TV ;
angeqaser	TV ;
angeqatigiip	XIPXmorf ;
angeqatigiissip	IV ;
angeqatig	TVschwa ;
angeqataa	IV ;
angeqi	K ;
angeqqik	K ;
angeqqip	XIiXmorf ;
angeqqissitsi	IV ;
angeqqisaap	IV ;
angeqqit	K ;
angeratar	IV ;
angerfigeqatigiip	XIPXmorf ;
angerfig	TVschwa ;
anger	IV ;
angerlajaar	IV ;
angerlaqqusi	IV ;
angerlaqqusaa	IV ;
angerlaqqu	TV ;
angerlar	IV ;
angerlarser	IV ;
angerlarsimaffig	TVschwa ;
angerlarsiummer	IV ;
angerlartussiaa	IV ;
angerlarumaar	IV ;
angerlarusukkaluar	IV ;
angerlarusup	IV ;
angerlorsior	IV ;
angerlortarsior	IV ;
angerluar	IV ;
angerlaap	XTuteXmorf ;
angerlaassi	IV ;
angerlaassor	XTPXmorf ;
angerlaa	XIPXmorf ;
angernerlup	IV ;
angersar	IV ;
angersar	TV ;
angersaa	IV ;
angersaar	TV ;
angertip	TV ;
angerutig	TVschwa ;
anger	XIiXmorf ;
anger	XTiXmorf ;
angigiilip	IV ;
angigikkup	TV ;
angigikkussi	IV ;
angigisaa	IV ;
angig	TVschwa ;
angi	IV ;
angikkulup	IV ;
angikulup	IV ;
angillorser	IV ;
angillorsior	IV ;
angillortarsior	IV ;
angilluinar	IV ;
angilluinnar	IV ;
angilluinnar	TV ;
angiluttorfig	TVschwa ;
angiluttor	IV ;
angiluttortip	TV ;
angiluttujui	IV ;
angiluttujuip	IV ;
angiluttujuip	XItsXmorf ;
angiluttujuitsuu	IV ;
angiluttuup	TV ;
angiluttuutig	TVschwa ;
angilaar	IV ;
angimip	IV ;
angimisivip	XTiXmorf ;
anginer	IV ;
angineru	IV ;
angingaar	IV ;
anginaar	TV ;
angip	IV ;
angip	TV ;
angisoorujussuu	IV ;
angisor	IV ;
angissuseqartip	TV ;
angisuatsiaa	IV ;
angisumukar	IV ;
angisuukasinngor	IV ;
angitig	TVschwa ;
angiuaar	IV ;
angivallaanngivip	XIiXmorf ;
angivallaar	IV ;
angivallaarsor	TVschwa ;
angivissorsuu	IV ;
angoor	IV ;
angoortaannaar	IV ;
angoqqator	IV ;
angorar	XIPXmorf ;
angorngior	IV ;
angornior	IV ;
angorniuutig	TVschwa ;
angorsor	XIPXmorf ;
angorsup	IV ;
angualli	IV ;
anguar	IV ;
anguartig	TVschwa ;
anguartissarsi	IV ;
anguartissarsior	IV ;
anguartissarsi	TV ;
anguartor	IV ;
anguartaa	IV ;
anguffap	IV ;
anguffarip	XIiXmorf ;
anguffarlup	IV ;
anguffarlutsig	TVschwa ;
anguffaser	IV ;
anguffasiler	XIiXmorf ;
angugajup	IV ;
anguigartor	TV ;
anguigartui	IV ;
anguigar	TV ;
anguikker	IV ;
anguikkior	IV ;
anguilersar	TVschwa ;
anguiler	TV ;
anguilaar	TV ;
angu	IV ;
angujorar	TV ;
angujui	IV ;
angujuip	IV ;
angujuip	XItsXmorf ;
angula	IV ;
angula	TV ;
angulersar	TVschwa ;
angullattaar	IV ;
angulluaqqusi	IV ;
angulaar	IV ;
angulaar	TV ;
anguma	IV ;
angumarsar	TVschwa ;
angumasassaa	IV ;
angumasassaanngivip	XIiXmorf ;
angumassaa	IV ;
angumassaanngivip	XIiXmorf ;
anguma	TV ;
angumeqqup	IV ;
angumeqqup	TV ;
angumereqqar	TV ;
angumereqqavip	XTiXmorf ;
angumerisoortip	IV ;
angumerisoortip	TV ;
angumerisoor	TV ;
angumer	IVschwa ;
angumersi	IV ;
angumersip	IV ;
angumer	TVschwa ;
angummap	IV ;
angummassimaannar	IV ;
angumaannar	TV ;
anguneqarsinnaa	IV ;
anguneqarsinnaanngivip	XIiXmorf ;
anguniagaqarusup	IV ;
anguniagarisar	TVschwa ;
anguniagar	TVschwa ;
anguniup	XIPXmorf ;
angunnunertaar	IV ;
angunnunnisar	IV ;
angusaqarluar	IV ;
anguseri	IV ;
anguseritoorsuu	IV ;
anguseritu	IV ;
angusi	IV ;
angusilluaqqusi	IV ;
angusinngitsoor	IV ;
angusisar	IV ;
angusisarpallaar	IV ;
angusisavip	XIiXmorf ;
angusissanga	IV ;
angusisuu	IV ;
angusisaatig	TVschwa ;
angusorsaa	IV ;
angussi	TV ;
angussor	IV ;
angussortip	TV ;
angussaa	IV ;
angussaar	IV ;
angussaavip	XIiXmorf ;
angusaannar	IV ;
anguteqatiminoor	IV ;
anguterasaar	IV ;
anguterpallap	IV ;
anguterpalup	IV ;
anguterpalaar	IV ;
anguterujussuu	IV ;
angutig	TVschwa ;
angutilerngusaap	IV ;
angutilersaar	IV ;
angutilersaarup	IV ;
angutinga	IV ;
angutinngoor	XIPXmorf ;
angutitar	IVschwa ;
angutitaa	IV ;
angutitaar	TVschwa ;
angutiviu	IV ;
angutiviaa	IV ;
anguttanger	IV ;
anguttariviu	IV ;
anguttuarpalup	IV ;
anguttuumisaar	IV ;
anguttuummi	IV ;
angu	TV ;
angutaagaluar	IV ;
angutaa	IV ;
angutaasanga	IV ;
angutaaserfiginnip	IV ;
angutaaserfig	TVschwa ;
angutaaser	IV ;
angutaassutaajar	TV ;
angutaasuu	IV ;
angutaasaa	IV ;
angutaatig	TVschwa ;
anguujaar	IV ;
anguuler	XIiXmorf ;
anguulivip	XIiXmorf ;
anguusior	IV ;
anguusior	TV ;
anguutersor	IV ;
anguutilior	IV ;
anguutilissuu	IV ;
angaar	TVschwa ;
ania	IV ;
aniar	IV ;
aniartor	IV ;
aniatitsi	IV ;
aniffig	TVschwa ;
anigajup	IV ;
anigasuar	IV ;
anigorluar	TV ;
anigorsar	TV ;
anigor	TV ;
anigui	IV ;
aniguisar	IV ;
aniguisar	TV ;
aniguisip	TV ;
aniguisitsi	IV ;
aniguisitaa	IV ;
anigui	TV ;
anigujoq	K ;
aniguup	IV ;
aniguup	TV ;
aniguussi	IV ;
aniguussaa	IV ;
aniinga	IV ;
aniingatip	TV ;
aniinngunar	IV ;
aniinni	IV ;
aniinniunnaar	IV ;
ani	IV ;
anikullatsip	IV ;
aniler	XIiXmorf ;
anillakar	IV ;
anillakaa	IV ;
anillakaap	IV ;
anillanga	IV ;
anillap	IV ;
anillatsiar	IV ;
anillatsiaannar	IV ;
anillattaar	IV ;
anillatuar	IV ;
anillaa	IV ;
anillaap	IV ;
anillaap	TV ;
anillaassi	IV ;
anillaa	TV ;
anilaarfittaar	IV ;
anima	IV ;
animmiaa	K ;
aningaasakip	XItsXmorf ;
aningaasaliissutig	TVschwa ;
aningaasanngor	TV ;
aningaasarsi	IV ;
aningaasarsior	IV ;
aningaasarsiorluar	IV ;
aningaaseri	IV ;
aningaasiveerser	IV ;
aningaasivilior	IV ;
aningaasivimmiitip	TV ;
aningaasaalatsi	IV ;
aningaasaarulluinnar	IV ;
aningaasaarup	IV ;
aningaasaatilissuu	IV ;
aningaasaataarup	IV ;
aninngisaannar	IV ;
aniorajup	IV ;
anior	IV ;
anipallap	IV ;
anip	TV ;
anisar	IV ;
anisar	IVschwa ;
anisarner	IV ;
anisarnersorsuu	IV ;
anisarnerunnaar	IV ;
aniserfig	TVschwa ;
aniser	IV ;
anisi	IV ;
anisip	IV ;
anisip	TV ;
anisitsi	IV ;
anisitsisar	IV ;
anisi	TV ;
anisitaa	IV ;
anisitaassagaluar	IV ;
anisoor	IV ;
anissamaaraluar	IV ;
anissamaar	IV ;
anissup	TV ;
anitsiar	IV ;
anitsiartitsi	IV ;
anitsi	IV ;
anitsisar	IV ;
aniui	IV ;
aniuip	IV ;
aniuip	XItsXmorf ;
aniumaataar	IV ;
aniutig	IVschwa ;
aniutig	TVschwa ;
aniaallu	IV ;
aniaar	IV ;
ankalaar	XIPXmorf ;
annaffillior	IV ;
annaffissar	TVschwa ;
annaffissi	TV ;
annagiar	IV ;
annakannajaar	IV ;
annakannajaavip	XIiXmorf ;
annakkajaar	IV ;
annakkuummer	IV ;
annanniutig	TVschwa ;
annap	IV ;
annaqqar	IV ;
annaqqarluinnar	IV ;
annaqqavip	IV ;
annaqqavip	XIiXmorf ;
annaqqaatig	TVschwa ;
annarlup	IV ;
annaser	IV ;
annassangajunnaaraluar	IV ;
annassangajunnaar	IV ;
annassangatsap	IV ;
annassangatsavip	XIiXmorf ;
annassimasinnaagaluar	IV ;
annassimasinnaa	IV ;
annassutig	TVschwa ;
annassutaa	IV ;
annatsip	TV ;
annatsitaa	IV ;
annattorsuu	IV ;
annattussaa	IV ;
annattussaajunnaar	XIiXmorf ;
annattutuaa	IV ;
anneraluar	IV ;
anner	IV ;
anner	IVschwa ;
annernaraluar	IV ;
annernar	IV ;
annernartorsuu	IV ;
annerpaa	IV ;
annersar	TVschwa ;
annersior	IV ;
annersior	TV ;
annersip	TV ;
annersitsi	IV ;
annertoorsuu	IV ;
annertoqqusersor	TV ;
annertoqquser	TV ;
annertoqqutig	TVschwa ;
annertoqqutaa	IV ;
annertuallaar	IV ;
annertug	TVschwa ;
annertu	IV ;
annertunerpaa	IV ;
annertuneru	IV ;
annertusiartor	IV ;
annertusiartortip	TV ;
annertusiartuinnar	IV ;
annertusigaluttuinnar	IV ;
annertusi	IV ;
annertussusileriigaa	IV ;
anner	TVschwa ;
anneru	IV ;
annerumaar	IV ;
annerungaar	IV ;
anneruniajuip	XItsXmorf ;
anneruniajuitsuu	IV ;
anneruniaannar	IV ;
anneruniaannartuu	IV ;
annerup	XTuteXmorf ;
annerussi	IV ;
annerussaar	IV ;
annerutip	IV ;
annerutip	TV ;
anneru	TV ;
anngajaar	IV ;
anngajaarsuugaluar	IV ;
anngajaarsuu	IV ;
anngalla	IV ;
anngallap	IV ;
anngalup	IV ;
anngaluttuinnaa	IV ;
anngarissaaraluar	IV ;
anngarissaar	IV ;
anngar	TV ;
annger	IV ;
anngersip	TV ;
anngiali	IV ;
anngigisaa	IV ;
anngig	TVschwa ;
anngiiarfig	TVschwa ;
anngiiar	IV ;
anngiiar	TV ;
anngiiaaffig	TVschwa ;
anngiiaatig	TVschwa ;
anngiorfig	TVschwa ;
anngior	IV ;
anngiortaannar	IV ;
anngip	IV ;
anngip	TV ;
anngiup	XTuteXmorf ;
anngiussi	IV ;
anngiaasar	IV ;
annguig	TVschwa ;
annguissaqqip	XIiXmorf ;
anngunniup	IV ;
anngup	IV ;
anngup	TV ;
annguteratar	IV ;
annguttoor	IV ;
annguttuulivip	XIiXmorf ;
annguttuunngisaannar	IV ;
anngaaginnar	IV ;
anngaaginnarpallaar	IV ;
anngaa	IV ;
anngaatip	TV ;
annia	IV ;
anniar	IV ;
anniartip	TV ;
anniartitsi	IV ;
anniartitsisar	IV ;
anniar	TVschwa ;
anniarujussualer	XIiXmorf ;
anniarujussuar	IV ;
anniavallaaqaar	IV ;
anniavallaar	IV ;
annikig	TVschwa ;
annikilli	IV ;
annikillilii	IV ;
annikillior	IV ;
annikilliortip	TV ;
annikilliortitsi	IV ;
annikillisip	TV ;
annikilli	TV ;
annikinaar	TV ;
annikip	XItsXmorf ;
annilaanga	IV ;
annilaanganar	IV ;
annilaanganaveersaar	IV ;
annilaangassutig	TVschwa ;
annilaanngap	IV ;
annilaanngatig	TVschwa ;
annilaar	IV ;
annilaarnar	IV ;
annilaarsar	TV ;
annilaarteqina	TV ;
annilaartip	TV ;
annilaartitsi	IV ;
annilaartaatig	TVschwa ;
annilaarup	TV ;
annilaarutig	TVschwa ;
annip	TV ;
annisiter	TV ;
annissi	IV ;
annissor	XTPXmorf ;
annitsivig	TVschwa ;
anniup	XTuteXmorf ;
anniussi	IV ;
anniussaa	IV ;
anniutig	TVschwa ;
anniutaa	IV ;
annivig	TVschwa ;
annivissior	IV ;
annivissaarup	IV ;
anniaatig	TVschwa ;
anniaataa	IV ;
annorasser	IV ;
annorasser	XTiXmorf ;
annorassi	IV ;
annorassior	IV ;
annoraalersor	XIPXmorf ;
annoraaler	XIiXmorf ;
annoraaler	XTiXmorf ;
annoraaliar	TVschwa ;
annoraalior	IV ;
annoraalior	TV ;
annoraarip	XIiXmorf ;
annoraarissaar	IV ;
annoraar	IV ;
annoraarlup	IV ;
annoraartip	TV ;
annoraartor	IV ;
annoraar	TV ;
annoraartaar	IV ;
annoraaver	IV ;
annoraaverser	IV ;
annoraaver	XTiXmorf ;
annoraaviar	IV ;
annuallap	IV ;
annuallatsip	TV ;
annuallaatig	TVschwa ;
annuataar	IV ;
annukujup	IV ;
annukujuppallaar	IV ;
annukuller	XIiXmorf ;
annup	IV ;
annuppallaar	IV ;
annuttaar	IV ;
annaajuma	IV ;
annaajumanngivip	TV ;
annaajuma	TV ;
annaakkiartor	TV ;
annaaler	XTiXmorf ;
annaalluginnip	IV ;
annaallugisaa	IV ;
annaallug	TVschwa ;
annaanaveersaar	TV ;
annaanaveer	TV ;
annaanaveer	XTiXmorf ;
annaanaviivip	XTiXmorf ;
annaangajap	TV ;
annaap	XTuteXmorf ;
annaaqqar	TV ;
annaaqqavip	TV ;
annaaqqup	IV ;
annaari	IV ;
annaar	IV ;
annaarpallaar	TV ;
annaartoor	TV ;
annaartuup	XIPXmorf ;
annaar	TV ;
annaasaqangaar	IV ;
annaassi	IV ;
annaassiniaqataa	IV ;
annaassiniartaataa	IV ;
annaassisig	TVschwa ;
annaassissutig	TVschwa ;
annaassutig	TVschwa ;
annaatari	IV ;
annaatar	IVschwa ;
annaatar	TVschwa ;
annaatsartor	TV ;
annaa	TV ;
anoor	XTPXmorf ;
anooraa	IV ;
anoreqanngingajap	IV ;
anorersualer	XIiXmorf ;
anorersualiup	TV ;
anorersualiussaa	IV ;
anorersuar	IV ;
anorersuarsior	IV ;
anorersuarsiortip	IV ;
anorersuartorsuu	IV ;
anorersuarujussuar	IV ;
anorikilli	IV ;
anorillior	IV ;
anorisar	IV ;
anorisior	IV ;
anorisiortip	IV ;
anorisaasior	IV ;
anoritoorsuu	IV ;
anoritu	IV ;
anori	TV ;
anorlersar	IV ;
anorlersorsuanngor	IV ;
anorlersorsuu	IV ;
anorler	XIiXmorf ;
anorlileqattaar	IV ;
anorliler	XIiXmorf ;
anorliliup	TV ;
anorliliussaa	IV ;
anorliorfig	TVschwa ;
anorlior	IV ;
anorliortip	TV ;
anorsalaallap	IV ;
anorsarip	XIiXmorf ;
anorsarissiartor	IV ;
anorsarissi	IV ;
anorsaalup	IV ;
anorsaaluttukasiu	IV ;
anorsaannguar	IV ;
anorsaannguaannar	IV ;
anorsaar	IV ;
anoraagajup	IV ;
anoraalukasiu	IV ;
anoraalup	IV ;
anoraaluttukasiu	IV ;
anoraasap	IV ;
anoraasar	IV ;
anoraasatsip	IV ;
anoraasatsip	TV ;
anoraasua	IV ;
anoraasuar	IV ;
anuer	TV ;
anulersor	TV ;
anulersui	IV ;
anuler	XTiXmorf ;
anusig	TVschwa ;
anusinngor	IV ;
anusinngorsar	IV ;
anusinngorsar	TV ;
anusinngorsaa	IV ;
anusinngujuer	IV ;
anusinngujuinaar	IV ;
anusinngujuinaar	TV ;
anusinngujuippallaar	IV ;
anusinngujuip	XItsXmorf ;
anusinnguup	XTuteXmorf ;
anusinnguutivip	TV ;
anu	TV ;
anaaleri	IV ;
anaalersar	TVschwa ;
anaaler	TV ;
anaaleruser	IV ;
anaanag	TVschwa ;
anaanar	TVschwa ;
anaanaarser	IV ;
anaanaartor	IV ;
anaanaartor	TV ;
anaanaarup	IV ;
anaarar	IV ;
anaarluer	IV ;
anaarluffig	TVschwa ;
anaarlup	IV ;
anaarlup	TV ;
anaarlussi	IV ;
anaarlussaaffig	TVschwa ;
anaarlussaap	IV ;
anaarlussaap	TV ;
anaarlussaassi	IV ;
anaasi	IV ;
anaatsiup	TV ;
anaa	TV ;
apeqqarippallaar	IV ;
apeqqarip	XIiXmorf ;
apeqqarissaarfig	TVschwa ;
apeqqarissaar	IV ;
apeqqarissaartuu	IV ;
apeqqip	IV ;
apeqqorip	IV ;
apeqqorip	XIiXmorf ;
apeqquser	TV ;
apeqqutig	TVschwa ;
apeqqutiller	XTiXmorf ;
apeqqutillii	IV ;
apeqqutissaqaraluar	IV ;
apereqqoor	IV ;
apereqqaarallar	TV ;
apereqqaar	IV ;
apereqqaar	TV ;
apererusukkaluar	IV ;
apererusup	IV ;
aperi	IV ;
aperiuminar	IV ;
aperlaarsior	IV ;
apersor	IV ;
apersorneqartip	IV ;
apersortip	IV ;
apersortitsi	IV ;
apersortittussaa	IV ;
apersor	TV ;
apersortaap	IV ;
apersorunnaar	IV ;
apersorunnaar	TV ;
apersui	IV ;
apersuisuu	IV ;
apersuukkunnaar	IV ;
apersuup	XIPXmorf ;
apersuuser	TV ;
apersuutigineqarluar	IV ;
apersuutig	TVschwa ;
apersuutaa	IV ;
aper	TVschwa ;
apiartuaar	IV ;
api	IV ;
apikkar	IV ;
apinerar	TV ;
apinnguatsiar	IV ;
apipeer	IV ;
apipiivip	XIiXmorf ;
apisar	IV ;
apissikar	IV ;
apissip	XItX ;
apissisip	TV ;
apissivip	XIiXmorf ;
apisaannar	IV ;
apitser	XTiXmorf ;
api	TV ;
apiunnarsi	IV ;
apivip	IV ;
apivip	XIiXmorf ;
aporallap	IV ;
aporallaap	XTPXmorf ;
aporap	IV ;
aporap	TV ;
aporfig	TVschwa ;
apor	IV ;
aporpallap	IV ;
aporsaar	TV ;
aportip	IV ;
aportip	TV ;
apor	TV ;
aportaa	IV ;
aportaali	TV ;
aporaap	XIPXmorf ;
appakar	IV ;
appakartip	TV ;
appakartoor	IV ;
appakarup	IV ;
appakar	XTPXmorf ;
appakaap	IV ;
appakaassor	XIPXmorf ;
appalerngusaap	XIPXmorf ;
appaliarsunniar	IV ;
appamiunukar	IV ;
appanniar	IV ;
appanniartip	IV ;
appanukar	IV ;
appap	IV ;
appariar	IV ;
appariartor	IV ;
appariartuler	XIiXmorf ;
appar	IV ;
apparnerpaa	IV ;
apparnia	IV ;
apparniar	TV ;
apparter	IV ;
appartip	TV ;
appartoor	IV ;
appartoortip	TV ;
appar	TV ;
appartaar	IV ;
appasi	IV ;
appasip	IV ;
appasip	XIiXmorf ;
appatassiissutig	TVschwa ;
appinissar	IV ;
appip	IV ;
appip	TV ;
appip	XItsXmorf ;
appisaluup	TV ;
appisaluussi	IV ;
appittartuu	IV ;
appittuu	IV ;
appiup	XTuteXmorf ;
appiussi	IV ;
appiussisar	IV ;
appukkaluttuinnar	TV ;
appulluinnar	TV ;
appup	TV ;
appussaa	IV ;
appaa	IV ;
appaallap	IV ;
appaallap	TV ;
appaallaqattaar	IV ;
appaallatsip	TV ;
appaamigallar	TV ;
appaami	IV ;
appaamisip	TV ;
appaamisaar	IV ;
appaamitsiar	TV ;
appaami	TV ;
appaarar	IV ;
appaar	IV ;
appaarup	XIuteXmorf ;
appaarutilernerar	TV ;
appaarutiler	XIiXmorf ;
ap	TV ;
apua	IV ;
apukap	IV ;
apukattartip	TV ;
apukattaap	TV ;
apukkaarip	IV ;
apukkaarip	XIiXmorf ;
apukkaarissi	IV ;
apuma	IV ;
apummi	IV ;
apummiu	IV ;
apuseri	IV ;
apuserisar	IV ;
apuserisar	TV ;
apuseritu	IV ;
apuseri	TV ;
apusi	IV ;
apusior	IV ;
apussarip	XIiXmorf ;
apussarissi	IV ;
apustiliu	IV ;
aputeqarluar	IV ;
aputeqartip	TV ;
aputerasaar	IV ;
aputikkoor	IV ;
aputilior	IV ;
aputinip	IV ;
aputisi	IV ;
aputitiimukar	IV ;
aputitaa	IV ;
aputaajar	TV ;
aputaajaa	IV ;
aputaajaar	IV ;
aputaajaasar	IV ;
aputaap	IV ;
aputaap	XItsXmorf ;
aputaar	IV ;
aputaarluer	IV ;
aputaarup	IV ;
aputaasalior	IV ;
aputaasap	IV ;
apuukkallar	IV ;
apuukkiartor	IV ;
apuukkiartortip	IV ;
apuukkumaar	IV ;
apuukkumaataar	IV ;
apuulluar	IV ;
apuunniuup	XIPXmorf ;
apuup	IV ;
apuup	TV ;
apuussor	IV ;
apuussor	XTPXmorf ;
apuuteqqar	IV ;
apuuteqqartuu	IV ;
apuuteqqavip	XIiXmorf ;
apuuteqqaanniuup	XIutePXmorf ;
apuuteqqaar	IV ;
apuuteqqaartuu	IV ;
apuutiaar	IV ;
apaapaartor	IV ;
apaasungar	TV ;
aqagup	IV ;
aqagutaar	IV ;
aqagutaar	TVschwa ;
aqaguukkaluar	TV ;
aqaguup	TV ;
aqajannguummer	IV ;
aqajannguummi	IV ;
aqajannguumminar	IV ;
aqajaqqeri	IV ;
aqajaqqer	IV ;
aqajaqqersimaar	IV ;
aqajaqqi	IV ;
aqajarukip	IV ;
aqajarukippallaar	IV ;
aqajarukip	XItsXmorf ;
aqajarululer	XIiXmorf ;
aqajarulup	IV ;
aqar	IV ;
aqartip	IV ;
aqar	TV ;
aqassui	IV ;
aqassup	IV ;
aqassup	TV ;
aqerlorteri	IV ;
aqerlorterisar	IV ;
aqerlorter	TV ;
aqerlor	TV ;
aqerlui	IV ;
aqerlulior	IV ;
aqerluusior	IV ;
aqig	TVschwa ;
aqili	IV ;
aqilileer	TV ;
aqilior	IV ;
aqiliortip	TV ;
aqilisar	TV ;
aqilisip	TV ;
aqilisaa	IV ;
aqilitip	TV ;
aqilitser	TV ;
aqillup	IV ;
aqilluttoor	IV ;
aqiloruartor	IV ;
aqiluallagiinnar	TV ;
aqiluallag	TVschwa ;
aqiluallak	K ;
aqilutuar	TVschwa ;
aqinneru	IV ;
aqinaar	TV ;
aqippallaar	IV ;
aqip	XItsXmorf ;
aqisseerup	IV ;
aqisser	IV ;
aqisserniar	IV ;
aqisserniartip	IV ;
aqisserpassuaqaraluar	IV ;
aqissertor	IV ;
aqissiliar	IV ;
aqissaarup	IV ;
aqi	TV ;
aqorliu	IV ;
aqqala	IV ;
aqqalasaar	IV ;
aqqaluartaar	IV ;
aqqalaa	IV ;
aqqalaap	XItsXmorf ;
aqqanililiup	TV ;
aqqanililiussi	IV ;
aqqaniliu	XIPXmorf ;
aqqaninngor	IV ;
aqqanner	TV ;
aqqar	IV ;
aqqarsaar	IV ;
aqqartartuu	IV ;
aqqar	TV ;
aqqorip	XIiXmorf ;
aqqorissaar	IV ;
aqqullaqqip	XIiXmorf ;
aqqullaqqivip	IV ;
aqqullaqqivip	XIiXmorf ;
aqqullior	IV ;
aqqullup	IV ;
aqqulluttukkoor	IV ;
aqqunar	IV ;
aqqunartip	IV ;
aqqunartip	TV ;
aqqunar	TV ;
aqqunaap	IV ;
aqqunaap	TV ;
aqqunaatig	TVschwa ;
aqqup	TV ;
aqquser	IV ;
aqquserngior	IV ;
aqqusernior	IV ;
aqquser	TV ;
aqquser	XIiXmorf ;
aqquser	XTiXmorf ;
aqqusinermiiginnar	IV ;
aqqusinikkoor	IV ;
aqqusiniliakkoor	IV ;
aqqusinilior	IV ;
aqqusinilior	TV ;
aqqusinner	IV ;
aqqusinner	XTiXmorf ;
aqqusinnior	IV ;
aqqusinnior	TV ;
aqqussi	IV ;
aqqussivig	TVschwa ;
aqqussui	IV ;
aqqusaaginnar	IV ;
aqqusaalutor	TVschwa ;
aqqusaap	TV ;
aqqusaari	IV ;
aqqusaarinnip	IV ;
aqqusaar	IV ;
aqqusaarlu	TV ;
aqqusaarsi	IV ;
aqqusaarsitsiar	IV ;
aqqusaar	TV ;
aqqusaarullup	XTuteXmorf ;
aqqusaarup	XTuteXmorf ;
aqqusaarussi	IV ;
aqqutigineqarsinnaa	IV ;
aqqutigip	XIiXmorf ;
aqqutigissi	IV ;
aqqutigissaar	IV ;
aqqutig	TVschwa ;
aqqutissarsior	IV ;
aqqutissarsiullaqqip	XIiXmorf ;
aqqutissar	TVschwa ;
aqqutissior	IV ;
aqqutissior	TV ;
aqqutissiui	IV ;
aqqutissiuisuu	IV ;
aqqutissaarup	IV ;
aqqutitip	TV ;
aqqutaasinnaa	IV ;
aqqaama	IV ;
aqqaamasar	IV ;
aqqaammartuip	XIiXmorf ;
aqqaammartu	IV ;
aqqaap	TV ;
aqqaater	TV ;
aqqaatiteri	IV ;
aqqaatiter	XTPXmorf ;
aqqaa	TV ;
aquar	IV ;
aquar	TV ;
aquiimi	IV ;
aquikkiartor	IV ;
aquimi	IV ;
aquimisaarfig	TVschwa ;
aquimisaar	IV ;
aquip	IV ;
aquitip	TV ;
aquler	XIiXmorf ;
aqullaqqip	XIiXmorf ;
aqullaqqissi	IV ;
aqullaqqissivip	XIiXmorf ;
aqulluar	IV ;
aqulluar	TV ;
aqullaaginnar	IV ;
aqullaar	IV ;
aqullaartip	TV ;
aqumeer	IV ;
aqunnga	IV ;
aqunngajoor	IV ;
aqupeqqa	IV ;
aqupi	IV ;
aqupisip	TV ;
aqup	IV ;
aqup	TV ;
aqussinnaa	IV ;
aqussinnaassuseqalersitsi	IV ;
aqussip	IV ;
aqutser	IV ;
aqutsi	IV ;
aqutsisinnaa	IV ;
aqutsisuu	IV ;
aquttagaa	IV ;
aquttorusiup	XIuteXmorf ;
aquttunngor	IV ;
aquttuu	IV ;
aquttuuneru	IV ;
aquttuusinnaa	IV ;
aquusior	IV ;
aquusior	TV ;
aquusiup	TV ;
aquuteralap	IV ;
aquuteralassi	IV ;
aquutermip	IV ;
aquutermip	TV ;
aquutersor	IV ;
aquutersor	TV ;
aquutig	TVschwa ;
aquutiler	TV ;
aquutaajar	IV ;
aquutaarser	IV ;
aqaasior	IV ;
aqaasior	TV ;
aqaasiuup	XTuteXmorf ;
aqaatig	TVschwa ;
aqaatilior	IV ;
aqaatiliuup	XTuteXmorf ;
arajoqqa	IV ;
arajunnar	IV ;
arajunnarsi	IV ;
arajunnarsivip	IV ;
arajunnarsivip	XIiXmorf ;
arajup	IV ;
arajup	TV ;
arajussi	IV ;
arajussaa	IV ;
arajutseqina	IV ;
arajutseqina	TV ;
arajutseqin	IVschwa ;
arajutsereer	XTiXmorf ;
arajutsi	IV ;
arajutsinaveersaar	IV ;
arajutsinaveersaar	TV ;
arajutsisip	TV ;
arajutsisitsi	IV ;
arajutsisaari	IV ;
arajutsisaar	TV ;
arajutsisaatsuu	IV ;
arajutsi	TV ;
arama	IV ;
arammap	IV ;
arammassimaar	IV ;
arbejdsmarkedskonsulentiu	IV ;
areer	XTiXmorf ;
arfammip	TV ;
arfammissaa	IV ;
arfanniaqartarallar	IV ;
arfanniar	IV ;
arfanniusior	IV ;
arfanniutaa	IV ;
arfap	IV ;
arfarmip	TV ;
arfattassiissutig	TVschwa ;
arfertassiissutig	TVschwa ;
arfiataar	TV ;
arfinileriar	IV ;
arfinileriar	TV ;
arfiniler	XTPXmorf ;
arfinileraar	IV ;
arfinilinngor	XTPXmorf ;
arfininngor	IV ;
arfininngorneru	IV ;
arfinner	XTPXmorf ;
arfinnii	IV ;
arfinniup	TV ;
arfinniussi	IV ;
arfior	IV ;
arfiusior	IV ;
arfiutaarser	IV ;
arfaamip	TV ;
ariinnar	IV ;
ariinnar	TV ;
arkitektiu	IV ;
arlaleriar	IV ;
arlaleriar	TV ;
arlaliup	TV ;
arlaliu	XIPXmorf ;
arlaqalaar	XIPXmorf ;
arlaqar	XIPXmorf ;
arlaqaalup	IV ;
arlariip	XIPXmorf ;
arlariissuu	IV ;
arlariiu	IV ;
arlerar	IV ;
arlerarpallaar	IV ;
arler	XTiXmorf ;
arliar	IV ;
arliar	TVschwa ;
arlig	TVschwa ;
arlii	IV ;
arliisaannar	IV ;
arli	IV ;
arlip	IV ;
arlip	TV ;
arliup	TV ;
arlivilior	IV ;
arlaap	XIPXmorf ;
arlaarsar	IV ;
arlaarsar	TV ;
arlaarsaasior	IV ;
arlaatassaarup	IV ;
arlaatsisar	IV ;
arlaataarup	IV ;
arnaffig	TVschwa ;
arnanga	IV ;
arnangavallaar	IV ;
arnannger	IV ;
arnanngoor	XIPXmorf ;
arnapalaa	IV ;
arnapalaaju	IV ;
arnapalaarsuu	IV ;
arnap	IV ;
arnaqquu	IV ;
arnarer	IV ;
arnarpallap	IV ;
arnarpalup	IV ;
arnarsiar	TVschwa ;
arnartatuaa	IV ;
arnar	TVschwa ;
arnartaa	IV ;
arneriffigisar	TV ;
arneriffig	TVschwa ;
arneri	IV ;
arneriniartitsisar	IV ;
arnerisar	IV ;
arneritoorsuu	IV ;
arnerituallaar	IV ;
arneritu	IV ;
arngajuerser	IV ;
arngajuerserniarallar	IV ;
arngajuer	XIiXmorf ;
arngajup	IV ;
arngali	IV ;
arngalip	IV ;
arngalisip	TV ;
arngili	IV ;
arngilip	IV ;
arngilisip	TV ;
arningiap	IV ;
arnisar	IV ;
arnisaatig	TVschwa ;
arnaasanga	IV ;
arnaasaa	IV ;
arnaatig	TVschwa ;
arnaatitaar	IV ;
arnaatitaar	TVschwa ;
arpakataar	IV ;
arpakkallar	IV ;
arpakkallar	TV ;
arpakulaar	IV ;
arpalerar	IV ;
arpalersoriar	IV ;
arpalersor	IV ;
arpaleraar	IV ;
arpaliup	XTuteXmorf ;
arpaliuteqattaar	XIPXmorf ;
arpaliutisi	IV ;
arpalorujoor	IV ;
arpalukusoor	IV ;
arpap	IV ;
arpap	TV ;
arpaqatigiip	XIPXmorf ;
arparrap	XIPXmorf ;
arparusaar	IV ;
arpasikaar	IV ;
arpatsiar	TV ;
arpatsip	TV ;
arpattagiar	IV ;
arpattartuu	IV ;
arpingiag	TVschwa ;
arpingiannar	IV ;
arpingiap	IV ;
arpissor	IV ;
arpaar	IV ;
arpaartip	TV ;
arpaartitsi	IV ;
arpaartitsivig	TVschwa ;
arpaar	TV ;
arraja	IV ;
arrajavallaar	IV ;
arrannar	IV ;
arrap	IV ;
arratsip	TV ;
arriilli	IV ;
arriillior	IV ;
arriillip	IV ;
arriillippallaar	IV ;
arriillivip	XIiXmorf ;
arriip	IV ;
arriippallaar	IV ;
arriip	XItsXmorf ;
arriisaar	IV ;
arriisaarpallaar	IV ;
arriisaavip	XIiXmorf ;
arriitsig	TVschwa ;
arri	IV ;
arriler	XIiXmorf ;
arrinngivip	IV ;
arrinngivip	XIiXmorf ;
arrisig	TVschwa ;
arrissutig	TVschwa ;
arritsap	IV ;
arritsatsip	TV ;
arritsavip	XIiXmorf ;
arritsaap	TV ;
arritsaatig	TVschwa ;
arriumagaluar	IV ;
arriuma	IV ;
arror	IV ;
arrorsar	TV ;
arrortinneqarsinnaa	IV ;
arrortip	TV ;
arruup	IV ;
arraa	IV ;
arraap	TV ;
arraatig	TVschwa ;
arraativip	TV ;
arsakoorfilior	IV ;
arsakoor	IV ;
arsariar	IV ;
arsar	IV ;
arsarner	IV ;
arsar	TVschwa ;
arsigitsaap	TV ;
arsi	IV ;
arsisorsuu	IV ;
arsissaar	IV ;
arsitsap	IV ;
arsitsavip	IV ;
arsitsavip	XIiXmorf ;
arsiunnaar	IV ;
arsivallaar	IV ;
arsugaa	IV ;
arsummukar	IV ;
arsup	TV ;
arsaaffig	TVschwa ;
arsaajaavig	TVschwa ;
arsaajaaviliar	TVschwa ;
arsaajaavilior	IV ;
arsaajaaviu	IV ;
arsaakkiar	IV ;
arsaakkiartor	IV ;
arsaanga	IV ;
arsaapiloor	TV ;
arsaap	IV ;
arsaap	TV ;
arsaarar	IV ;
arsaarinnip	IV ;
arsaarinnissutig	TVschwa ;
arsaar	TV ;
arsaaraa	IV ;
arsaassutisi	IV ;
arsaateqatigiip	XIPXmorf ;
arsaatilersaar	IV ;
arsaatillaqqip	XIiXmorf ;
arsaatillaqqivip	XIiXmorf ;
arsaattartuu	IV ;
artor	IV ;
artornakkulup	IV ;
artornar	IV ;
artornartorsior	IV ;
artornartorsiortip	TV ;
artorsajuip	XItsXmorf ;
artorsajuitsuu	IV ;
artorsar	IV ;
artorsartip	TV ;
artorsartitsi	IV ;
artorsip	TV ;
artorsitsaar	TV ;
artorsaatig	TVschwa ;
artor	TV ;
artorunnaar	TV ;
artugarinngivip	TV ;
artugar	IVschwa ;
artugar	TVschwa ;
artugaa	IV ;
artukkersor	TV ;
artukkersui	IV ;
artukkersuutaa	IV ;
artukker	XTiXmorf ;
artuler	IV ;
artulersip	TV ;
artuler	TV ;
artuler	XIiXmorf ;
artuler	XTiXmorf ;
aruma	IV ;
asagaluar	TV ;
asa	IV ;
asajuar	TV ;
asajunnaar	TV ;
asakkallar	TV ;
asaler	XTiXmorf ;
asalluar	TV ;
asanaq	K ;
asanar	IV ;
asanarnerpaa	IV ;
asanarnerpaajutig	TVschwa ;
asaneqangaar	IV ;
asanerpaa	TV ;
asaneruler	TV ;
asaneruler	XTiXmorf ;
asaneru	TV ;
asannikkajup	IV ;
asannileqqaar	IV ;
asannilersoor	IV ;
asanniler	XIiXmorf ;
asannilluar	IV ;
asanningaar	IV ;
asanninneru	IV ;
asannip	IV ;
asannippasip	XIiXmorf ;
asannittuusaar	IV ;
asannituu	IV ;
asannituusaar	IV ;
asanaatig	TVschwa ;
asap	IV ;
asap	TV ;
asaqatigiip	IV ;
asaqatigiip	XIPXmorf ;
asaqqutuu	IV ;
asasamaar	TV ;
asasar	TVschwa ;
asasigiip	XIPXmorf ;
asasig	TVschwa ;
asassutaa	IV ;
asasunnguu	IV ;
asatsip	TV ;
asattuar	IV ;
asattuup	TV ;
asattuussi	IV ;
asattuussaa	IV ;
asattaap	IV ;
asattaap	XItsXmorf ;
asa	TV ;
asavip	XTiXmorf ;
aseer	TV ;
aseer	XTiXmorf ;
aseqqorip	XIiXmorf ;
aseqqorlup	IV ;
aseqqukuu	IV ;
aseqqula	IV ;
aserfala	IV ;
aserfallaja	IV ;
aserfallajuip	XItsXmorf ;
aserfallajaap	IV ;
aserfallajaap	XItsXmorf ;
aserfallap	IV ;
aserfallatsaalii	IV ;
aserfallatsaalior	TV ;
aserfallatsaali	TV ;
aserfallatsaaliui	IV ;
aserfallattaalior	TV ;
aserfallattaaliui	IV ;
aserfallavip	IV ;
aserfallavip	XIiXmorf ;
aserli	IV ;
aserlior	IV ;
asernikip	XItsXmorf ;
aseroraluttuinnar	IV ;
aseroraluttuinnar	TV ;
aseroriartor	IV ;
aseroriartuinnar	IV ;
aseroriartuinnar	TV ;
aseror	IV ;
aserorluinnar	IV ;
aserorluinnar	TV ;
aserornar	IV ;
aserorsar	TV ;
aserorsinnaa	IV ;
aserorsaa	IV ;
aserorsaari	IV ;
aserorsaar	TV ;
aserorsaataa	IV ;
aserorteri	IV ;
aserorterisar	IV ;
aserorter	TV ;
aserortoor	IV ;
aseror	TV ;
aserpasip	IV ;
aserpasip	XIiXmorf ;
aseruatiter	IV ;
aseruatiter	XTiXmorf ;
aserua	XIPXmorf ;
aserui	IV ;
aseruissagaluar	IV ;
aserui	TV ;
aseruja	IV ;
aserujassangatip	TV ;
aserujuip	XItsXmorf ;
aserujaap	XItsXmorf ;
aserutsaaliui	IV ;
aserutsaaliuisar	IV ;
aseruup	XIuteXmorf ;
aseruutig	TVschwa ;
aseruutiler	XIiXmorf ;
aseruutissior	IV ;
aseruutissior	TV ;
aseruuttoor	IV ;
asfalteri	IV ;
asfalterisar	IV ;
asialuip	XItsXmorf ;
asialuitsuu	IV ;
asialup	IV ;
asialuu	IV ;
asianerip	XIiXmorf ;
asiaqatig	TVschwa ;
asiarajup	IV ;
asiar	IV ;
asiarpasip	IV ;
asiarpasip	XIiXmorf ;
asiarsimallutip	IV ;
asiginnar	TV ;
asiginnaa	IV ;
asig	TVschwa ;
asiilag	TVschwa ;
asiila	IV ;
asiilanaar	TV ;
asiillariartor	IV ;
asiillar	IV ;
asiillartip	TV ;
asiillarup	IV ;
asiillaruttoor	IV ;
asiillaa	TV ;
asiinalior	IV ;
asikataa	IV ;
asiler	TVschwa ;
asima	IV ;
asimiussi	IV ;
asimiussip	IV ;
asimukar	IV ;
asinga	IV ;
asingavallaar	IV ;
asinnar	IV ;
asinngap	IV ;
asinngar	IV ;
asinngaap	TV ;
asissor	TV ;
asissui	IV ;
asissuutaa	IV ;
asiu	IV ;
asiunaveersar	TV ;
asiunaveersaa	IV ;
asiunaveersaasar	IV ;
asiusoor	IV ;
asiusoortip	TV ;
asiutip	TV ;
asiutitsi	IV ;
asiutitsisar	IV ;
asiaa	IV ;
asiaap	TV ;
as'ma	IV ;
asoor	IV ;
asoorup	TV ;
asoorussi	IV ;
assagiarsunniar	IV ;
assagiarsunniutitaar	IV ;
assagiikkuser	IV ;
assagiikkusior	IV ;
assagip	XIiXmorf ;
assakap	IV ;
assakar	IV ;
assakartip	TV ;
assakip	XItsXmorf ;
assakaa	IV ;
assakaalaar	IV ;
assakaasar	IV ;
assakaatip	TV ;
assaligup	TV ;
assaligusior	IV ;
assalii	IV ;
assalikaarutig	TVschwa ;
assalip	TV ;
assalittaa	IV ;
assallap	IV ;
assallap	TV ;
assallatseri	IV ;
assallatserip	IV ;
assallatserisar	IV ;
assallatser	XTiXmorf ;
assallatsip	IV ;
assallup	IV ;
assallaa	IV ;
assallaannar	TV ;
assammii	IV ;
assammiortaar	IV ;
assammip	IV ;
assammip	TV ;
assammissaap	XIPXmorf ;
assammiulersor	IV ;
assammiulisaar	IV ;
assammoor	TV ;
assapalip	IV ;
assapalitsip	IV ;
assap	IV ;
assap	TV ;
assaqaler	XIiXmorf ;
assaqqoriip	IV ;
assar	IV ;
assarner	IV ;
assarnersorsuu	IV ;
assarniler	XIiXmorf ;
assarnaalup	IV ;
assarnaaluttukasiu	IV ;
assarnaannguar	IV ;
assarnaar	IV ;
assartor	IV ;
assartor	TV ;
assartui	IV ;
assartuisar	IV ;
assartuisitsi	IV ;
assartuisitsisuu	IV ;
assartuutig	TVschwa ;
assar	TVschwa ;
assassoriar	IV ;
assassoriarsor	IV ;
assassor	IV ;
assassor	TV ;
assassorujoor	IV ;
assassullaqqip	XIiXmorf ;
assassullaqqivip	XIiXmorf ;
assatar	TVschwa ;
assattor	IV ;
assattor	TV ;
asseqanngivip	XIiXmorf ;
asser	IV ;
asserluinnar	TVschwa ;
assersor	TV ;
assersui	IV ;
assersuup	TV ;
assersuussi	IV ;
assersuutigiinnar	TV ;
assersuutigiinnavip	XIiXmorf ;
assersuutig	TVschwa ;
assersuutaa	IV ;
assersuutaannaa	IV ;
asser	TV ;
asser	TVschwa ;
asser	XIiXmorf ;
asser	XTiXmorf ;
assiaqattaap	IV ;
assiaqattaar	TV ;
assiaqusersor	TV ;
assiaquser	TV ;
assiaqutig	TVschwa ;
assiaqutsersor	TV ;
assiaqutsersui	IV ;
assiaqutser	TV ;
assiaqutaa	IV ;
assiar	IV ;
assiar	TV ;
assiar	TVschwa ;
assigiikkuutaar	XIPXmorf ;
assigiinngisitsi	IV ;
assigiinngitsuu	IV ;
assigiip	XIPXmorf ;
assigiissip	TV ;
assigiissaar	XTPXmorf ;
assigiiaarpallaaler	XIPXmorf ;
assigiiaartunngortip	TV ;
assigiiaar	XIPXmorf ;
assigiler	XTiXmorf ;
assigitip	TV ;
assigivip	TV ;
assig	TVschwa ;
assii	IV ;
assi	IV ;
assilialior	IV ;
assiliartalii	IV ;
assiliartaliisar	IV ;
assilii	IV ;
assiliisar	IV ;
assiliisartuu	IV ;
assilisassip	TV ;
assilisip	IV ;
assilisip	TV ;
assilisittartuu	IV ;
assilisaa	IV ;
assili	TV ;
assiliaa	IV ;
assiliaatig	TVschwa ;
assingajag	TVschwa ;
assinguinnar	IV ;
assingu	IV ;
assingulluinnar	IV ;
assingunngilluinnar	IV ;
assingunngivip	XIiXmorf ;
assingusaar	IV ;
assingutip	TV ;
assingutitsi	IV ;
assinip	IV ;
assior	IV ;
assipalug	TVschwa ;
assipassug	TVschwa ;
assisar	IV ;
assiu	IV ;
assiup	IV ;
assoor	IV ;
assoqqup	IV ;
assoqqup	TV ;
assorali	IV ;
assoralinar	IV ;
assoralisimaar	IV ;
assorap	IV ;
assorassimaar	IV ;
assorip	IV ;
assorip	XIiXmorf ;
assor	IV ;
assoroor	IV ;
assoroornartuleri	IV ;
assoroortip	TV ;
assoror	IV ;
assorortip	TV ;
assorpar	IV ;
assorparter	IV ;
assortornaar	TV ;
assortortig	TVschwa ;
assortor	TV ;
assortui	IV ;
assortuisar	IV ;
assortuup	IV ;
assortuussutig	TVschwa ;
assortuutigisassaa	IV ;
assor	TV ;
assorup	IV ;
assoruuip	XIiXmorf ;
assoruumisaar	IV ;
assoruupilup	IV ;
assoruup	IV ;
assoruup	TV ;
assoruutig	TVschwa ;
assoruutsip	IV ;
assoruutsip	TV ;
assuarinnip	IV ;
assuar	IV ;
assuarlerajup	IV ;
assuarlersig	TVschwa ;
assuarler	XIiXmorf ;
assuarliutig	TVschwa ;
assuarnanngivip	XIiXmorf ;
assuarnar	IV ;
assuarnaag	TVschwa ;
assuarnaap	IV ;
assuarnaap	XItsXmorf ;
assuarnaar	TV ;
assuarnaateqanngivip	XIiXmorf ;
assuartip	TV ;
assuar	TVschwa ;
assuataar	IV ;
assuffap	IV ;
assuffattorsuu	XIPXmorf ;
assukanner	IV ;
assukker	IV ;
assukkersor	IV ;
assukkersor	TV ;
assummaarip	IV ;
assummaarip	XIiXmorf ;
assummaarissaar	IV ;
assumoor	IV ;
assumukar	IV ;
assumukaar	IV ;
assunger	TV ;
assunger	XTiXmorf ;
assup	TV ;
assuuser	IV ;
assuusersor	IV ;
assuuser	XTiXmorf ;
assuusisaar	IV ;
assuutig	TVschwa ;
assuutaar	IV ;
assaa	IV ;
assaaler	XIiXmorf ;
assaap	TV ;
assaar	IV ;
assaarsigajup	IV ;
assaarsigup	IV ;
assaarsii	IV ;
assaarsiisar	IV ;
assaarsi	IV ;
assaar	TV ;
assaatinngu	IV ;
asukeer	IV ;
asukeertuinnar	IV ;
asukeertaannar	IV ;
asukiar	TVschwa ;
asuleer	IV ;
asuleerpallaar	IV ;
asuleer	XIiXmorf ;
asuliinnalior	IV ;
asuliinnar	IV ;
asuliinnartip	TV ;
asuliinnaa	IV ;
asaagajup	IV ;
asaa	IV ;
asaajuma	IV ;
asaajumaar	IV ;
asaarisaa	IV ;
asaar	IV ;
asaar	TVschwa ;
asaasar	IV ;
asaasartuu	IV ;
asaasuu	IV ;
asaasaannar	IV ;
asaatig	TVschwa ;
ata	IV ;
atajuar	IV ;
atalip	IV ;
atalluar	IV ;
atallaaver	IV ;
atamertar	TVschwa ;
atamertaa	IV ;
atamertaaler	XIiXmorf ;
atammap	IV ;
atammattorsuu	IV ;
atammiinnarsuu	IV ;
atammimmukar	IV ;
atamaar	XIPXmorf ;
ataneerup	IV ;
ataneerutivip	XIiXmorf ;
atanertu	IV ;
atangersoriar	TV ;
atangersor	TV ;
atangertip	IV ;
atanger	XTiXmorf ;
atangii	IV ;
atangiup	IV ;
atangiup	TV ;
atanikip	XItsXmorf ;
atanitannguerup	IV ;
atapaller	XIiXmorf ;
atapaa	IV ;
ataqatigiip	IV ;
ataqatigiip	XIPXmorf ;
ataqatigiiaar	XIPXmorf ;
ataqqar	IV ;
ataqqarluinnar	IV ;
ataqqeqqutu	IV ;
ataqqeqqutuu	IV ;
ataqqigaluar	TV ;
ataqqinar	IV ;
ataqqinarnerutip	TV ;
ataqqinartip	TV ;
ataqqinartorsuu	IV ;
ataqqinnip	IV ;
ataqqinnittuu	IV ;
ataqqinaaser	XTiXmorf ;
ataqqinaasii	IV ;
ataqqinaateqaruma	IV ;
ataqqinaatig	TVschwa ;
ataqqisar	TVschwa ;
ataqqisaa	IV ;
ataqqi	TV ;
ataquser	IV ;
ataquser	TV ;
ataqutitaar	IV ;
atassuteqarfig	TVschwa ;
atassutig	TVschwa ;
atassutaarup	IV ;
atassutaaruttoor	IV ;
atassutaaruttoorup	IV ;
atatiinnar	TV ;
atatip	TV ;
atatitsi	IV ;
atatitsisinnaa	IV ;
atatsi	IV ;
ata	TV ;
ateeriilluinnar	XIPXmorf ;
ateeriip	XIPXmorf ;
ateer	TVschwa ;
atequseqartip	TV ;
atequser	IV ;
atequtitaar	IV ;
ateqaatersor	IV ;
ateqaatig	TVschwa ;
aterartaar	IV ;
aterertaar	IV ;
aterfig	TVschwa ;
aterfior	IV ;
ateriiar	IV ;
ateriler	TV ;
ater	IV ;
aterivip	XTiXmorf ;
aterlaler	XIiXmorf ;
atersi	TV ;
atersor	IV ;
atersaarfig	TVschwa ;
atersaar	IV ;
aterter	IV ;
ater	TVschwa ;
atertaar	IV ;
atertaar	TVschwa ;
ateruseqartip	TV ;
ateruser	TVschwa ;
ateraasartaar	IV ;
ateraasior	IV ;
ateraasiortuu	IV ;
atigasor	TVschwa ;
atiimaar	IV ;
atiimaar	TV ;
atiimaartaannar	TV ;
ati	IV ;
atikilli	TV ;
atikinaar	TV ;
atikip	XItsXmorf ;
atikor	TVschwa ;
atikuler	XTiXmorf ;
atiler	XIiXmorf ;
atiler	XTiXmorf ;
atisalersor	IV ;
atisalersor	TV ;
atisalup	IV ;
atisassarsi	IV ;
atisassarsior	IV ;
atisassior	IV ;
atisassior	TV ;
atisassip	TV ;
atisassaaleqi	IV ;
atisi	IV ;
atisaajar	IV ;
atisaar	IV ;
atitip	TV ;
atittoqquser	XTiXmorf ;
atittor	IV ;
atittor	TV ;
atitu	IV ;
atituneru	IV ;
atitunaar	TV ;
ati	TV ;
atlantikorsuakkoor	IV ;
atlantikukkoor	IV ;
atoqatigiip	XIPXmorf ;
atoqqaarfissior	IV ;
atoqqaarfissiortip	TV ;
atoqqaartip	TV ;
atoqqaartitsi	IV ;
atorajunnerpaa	IV ;
atorajunneru	IV ;
atorajup	IV ;
atorfinip	IV ;
atorfinitsip	TV ;
atorfinitsitsisussaatitaa	IV ;
atorfinitsitsisuu	IV ;
atorfinitsitaa	IV ;
atorfissaqartinneqaraluar	IV ;
atorfissaqartip	TV ;
atorfissarsi	IV ;
atorfissarsioraluar	IV ;
atorfissarsior	IV ;
atorfissaarup	IV ;
atorfissaarutsip	TV ;
ator	IV ;
atoriaannaa	IV ;
atorluar	IV ;
atorluarsinnaa	IV ;
atorluar	TV ;
atorluaa	IV ;
atorneerup	IV ;
atorneqaratarsinnaa	IV ;
atorneqarnerpaa	IV ;
atorneqarsinnaa	IV ;
atornerlui	IV ;
atornerlup	TV ;
atorpallaar	TV ;
atorsaror	IV ;
atorsarorneru	IV ;
atorsarorsiigaluar	IV ;
atorsarorsiigaluar	TV ;
atorsarorsii	IV ;
atorsaruup	TV ;
atorsinnaa	IV ;
atorsinnaajunnaar	IV ;
atorsinnaanngor	IV ;
atorsinnaanngortip	TV ;
atorsinnaanngor	TV ;
atorsinnaa	TV ;
atorsup	IV ;
atorsaa	IV ;
atortussanngortitaa	IV ;
atortuu	IV ;
atortuujunnaar	IV ;
atortuujunnaarsip	TV ;
atortuujunnaarsitsi	IV ;
atortuulersip	TV ;
atortuuler	XIiXmorf ;
ator	TV ;
atorumagaluar	IV ;
atorumagaluar	TV ;
atoruma	IV ;
atoruma	TV ;
atoruminar	IV ;
atoruminarsar	TV ;
atoruminarsaa	IV ;
atoruminaap	XItsXmorf ;
atorunnaar	IV ;
atorunnaarsip	TV ;
atorunnaarsitsi	IV ;
atorunnaar	TV ;
atsag	TVschwa ;
atsakkuminar	IV ;
atsalisar	IV ;
atserar	TV ;
atseri	IV ;
atsersor	TV ;
atsersui	IV ;
atsersuisar	IV ;
atser	TV ;
atser	XTiXmorf ;
atseraa	IV ;
atsiar	TVschwa ;
atsig	IVschwa ;
atsigaa	IV ;
atsi	IV ;
atsikkutigiip	XIPXmorf ;
atsikkutigiissaar	XTPXmorf ;
atsinertu	IV ;
atsinikip	XItsXmorf ;
atsinnerpaa	IV ;
atsinneru	IV ;
atsioqatigiip	XIPXmorf ;
atsioqataa	IV ;
atsior	IV ;
atsior	TV ;
atsipallaar	IV ;
atsip	IV ;
atsip	XIiXmorf ;
atsipaaquser	IV ;
atsipaaquser	TV ;
atsissi	IV ;
atsi	TV ;
atsiui	IV ;
atsiup	TV ;
atsiussi	IV ;
atsiussaa	IV ;
atsiuuser	TV ;
atsiuutser	TV ;
atsiaa	IV ;
atsunger	TV ;
attakoor	IV ;
attakusior	IV ;
attakusiortuu	IV ;
attalluarsinnaa	TV ;
attanukar	IV ;
attap	TV ;
attar	IVschwa ;
attarmeer	IV ;
attarmoor	XIPXmorf ;
attarnarunnaar	IV ;
attarsi	IV ;
attarsi	TV ;
attartor	IV ;
attartortip	TV ;
attartortugaa	IV ;
attartor	TV ;
attartoruup	IV ;
attartoruussaa	IV ;
attartugaa	IV ;
attartu	IV ;
attartunersaa	IV ;
attar	TVschwa ;
attaser	IV ;
attasersor	TV ;
attasersui	IV ;
attaser	XTiXmorf ;
attasii	IV ;
attassi	IV ;
attassaa	IV ;
attataler	TV ;
attatar	TVschwa ;
attatser	TV ;
attatsii	IV ;
attataa	IV ;
attataajar	IV ;
attataajar	TV ;
attataap	IV ;
attataar	IV ;
attataarser	IV ;
attataar	TV ;
attavigilluar	TV ;
attaviginnip	IV ;
attavig	TVschwa ;
attaviulluar	IV ;
attoqisaagaa	IV ;
attoqisaarinnip	IV ;
attoqisaar	TV ;
attoqusersor	TV ;
attoqutsersui	IV ;
attoqutser	TV ;
attoqutsiup	TV ;
attor	IV ;
attorsup	IV ;
attortaraap	XIPXmorf ;
attor	TV ;
attortaali	IV ;
attualaar	TV ;
attuaqisaar	TV ;
attui	IV ;
attuisar	IV ;
attukisar	TV ;
attukuluup	IV ;
attuliar	IV ;
attumukar	IV ;
attunger	TV ;
attunngisungar	TV ;
attunngisungaannar	TV ;
attupillap	TV ;
attupillaannar	TV ;
attuua	TV ;
attuulluar	IV ;
attuulluartip	TV ;
attuuma	IV ;
attuumalluar	IV ;
attuumatip	TV ;
attuuma	TV ;
attuup	IV ;
attuup	XIuteXmorf ;
attuup	XTuteXmorf ;
attuussar	IV ;
attuussarnaveeqquser	IV ;
attuussarnaveeqquser	TV ;
attuussarnaveeqquser	XTiXmorf ;
attuussarpalup	IV ;
attuutivip	XIiXmorf ;
attaaser	IV ;
attaaser	TV ;
attaasii	IV ;
attaatig	TVschwa ;
atuagassior	IV ;
atuakkeri	IV ;
atuakkerisar	IV ;
atuakkiar	TVschwa ;
atuakkior	IV ;
atuakkiortuu	IV ;
atuakkiaa	IV ;
atualeqqaar	IV ;
atualer	XIiXmorf ;
atuallap	TV ;
atuallaqqip	XIiXmorf ;
atuallaa	IV ;
atuanngitsoor	IV ;
atuaqatigiip	XIPXmorf ;
atuaqatig	TVschwa ;
atuaqqip	IV ;
atuaqqip	TV ;
atuarajup	IV ;
atuareer	IV ;
atuarfiu	IV ;
atuariartor	IV ;
atuar	IV ;
atuarnerlup	IV ;
atuarnerluppallaar	IV ;
atuarser	IV ;
atuarsinnaagaluar	IV ;
atuarsinnaa	IV ;
atuarsinnaaler	XIiXmorf ;
atuarsinnaanngor	IV ;
atuartip	TV ;
atuartitsi	IV ;
atuartitsisar	IV ;
atuartitsissutig	TVschwa ;
atuartitsisuu	IV ;
atuartuu	IV ;
atuar	TV ;
atuffap	IV ;
atuffap	TV ;
atuffarip	XIiXmorf ;
atuffarissi	IV ;
atuffarissivip	XIiXmorf ;
atuffarissaar	IV ;
atuffarlior	IV ;
atuffarlior	TV ;
atuffarlup	IV ;
atuffarluppallaar	IV ;
atuffaser	IV ;
atuffassi	IV ;
atuffassisar	IV ;
atuffassissutig	TVschwa ;
atugarlior	IV ;
atugarliornar	IV ;
atugartuunngorsar	IV ;
atugartuunngorsar	TV ;
atugaa	IV ;
atugaavallaar	IV ;
atui	IV ;
atuillaqqip	XIiXmorf ;
atuinerlup	IV ;
atuisuu	IV ;
atuiuma	IV ;
atukkersor	IV ;
atukkersor	TV ;
atukker	XTiXmorf ;
atukkii	IV ;
atukkiisar	IV ;
atukkip	TV ;
atukkittat	TV ;
atukkiup	TV ;
atukkiussi	IV ;
atukkiussisar	IV ;
atukkiussaa	IV ;
atukula	IV ;
atukula	TV ;
atukulup	TV ;
atulerseqqip	TV ;
atulersip	TV ;
atungassiar	TVschwa ;
atungassi	IV ;
atungaar	TV ;
atunnger	IV ;
atunngersuu	IV ;
atunnger	XTiXmorf ;
atunngii	IV ;
atunngillaqqip	XIiXmorf ;
atunngillaqqissuu	IV ;
atunngilluinnar	IV ;
atunngitsoor	IV ;
atunngitsoor	TV ;
atunngiutig	TVschwa ;
atunni	IV ;
atunnilaar	IV ;
atussaa	IV ;
atuukkunnaar	IV ;
atuukkunnaarsip	TV ;
atuulluar	IV ;
atuup	IV ;
atuup	TV ;
atuusar	IV ;
atuusaa	IV ;
atuusaar	IV ;
atuusaar	TV ;
atuaa	IV ;
atuaap	TV ;
atuaaseritip	IV ;
atuaaser	TVschwa ;
atuaatig	TVschwa ;
atuaa	TV ;
ataannukar	IV ;
ataanukar	IV ;
ataap	IV ;
ataap	TV ;
ataaqqukkiartor	IV ;
ataaqqukkiartor	TV ;
ataaqqup	IV ;
ataaqqup	TV ;
ataar	IV ;
ataar	TV ;
ataarup	TV ;
ataarutisi	IV ;
ataaseeri	IV ;
ataaseer	IV ;
ataaseer	TV ;
ataaseriar	IV ;
ataaseriar	TV ;
ataaseraaginnar	IV ;
ataaseraaqqar	IV ;
ataaseraar	IV ;
ataasiakkuutaar	XTPXmorf ;
ataasiakkaaginnar	XIPXmorf ;
ataasiakkaar	XIPXmorf ;
ataasiakkaar	XTPXmorf ;
ataasialisaar	IV ;
ataasiar	IV ;
ataasiartaa	IV ;
ataasiinnaa	IV ;
ataasi	IV ;
ataasinngor	IV ;
ataasinngorneru	IV ;
ataasinngorpiar	IV ;
ataasinngor	TV ;
ataasioqatig	TVschwa ;
ataasiu	IV ;
ataasiaa	IV ;
ataasiaannavip	XIiXmorf ;
ataasungar	IV ;
ataasungar	TV ;
ataatarpoor	IV ;
ataatarpunaar	IV ;
ataatar	TVschwa ;
ataatassarsiui	IV ;
ataatsi	IV ;
ataatsikkoor	IV ;
ataatsikkoorluinnar	IV ;
ataatsikkoortip	TV ;
ataatsikkoor	TV ;
ataatsimeersuar	IV ;
ataatsimiigiaqqusi	IV ;
ataatsimiigiar	IV ;
ataatsimiitip	IV ;
ataatsimiitip	TV ;
ataatsimiititalior	IV ;
ataatsimiititaliortitsi	IV ;
ataatsimiititsi	IV ;
ataatsimiittukkuutaar	IV ;
ataatsimoor	IV ;
ataatsimoortukkuutaar	XIPXmorf ;
ataatsimoorup	TV ;
ataataa	IV ;
ataataartor	IV ;
ataataarup	IV ;
ataavaa	IV ;
avalagar	XIPXmorf ;
avalakaa	XIPXmorf ;
avalanneru	IV ;
avalannialer	XIiXmorf ;
avalap	IV ;
avalap	TV ;
avalassaanga	IV ;
avalassaar	IV ;
avalassaartip	TV ;
avalatsip	TV ;
avalattaaser	TV ;
avalavinnialer	XIiXmorf ;
avaleqqunip	IV ;
avalequsersor	TV ;
avalequtaa	IV ;
avalequtaarup	IV ;
avalerartor	IV ;
avalerartor	TV ;
avaleraasartoortor	IV ;
avalisaarser	IV ;
avalisaarser	TV ;
avalitser	IV ;
avalitsersor	IV ;
avallersaa	IV ;
avalliu	IV ;
avalliussaa	IV ;
avallup	IV ;
avalaa	IV ;
avalaaller	XIiXmorf ;
avalaap	IV ;
avalaap	TV ;
avalaassi	IV ;
avalaassup	TV ;
avalaa	TV ;
avammoor	IV ;
avammoortip	TV ;
avammukar	IV ;
avammukaap	XTPXmorf ;
avammukaa	XIPXmorf ;
avanersuarmukar	IV ;
avannaliup	TV ;
avannamukar	IV ;
avannamukaa	IV ;
avannamukaap	XTuteXmorf ;
avannamukaassi	IV ;
avannaqqup	TV ;
avannarlermukar	IV ;
avannarpar	IV ;
avannarparter	IV ;
avannarpasinaar	IV ;
avannarpasinaar	TV ;
avannarpasip	IV ;
avannarpasip	XIiXmorf ;
avannerajup	IV ;
avannerajussi	IV ;
avanner	IV ;
avannersorsuu	IV ;
avanngasip	IV ;
avanngasip	XIiXmorf ;
avanngasissoor	IV ;
avanngaa	IV ;
avanniliup	TV ;
avanniliussaa	IV ;
avanningaatsiar	IV ;
avannaamiuu	IV ;
avannaannguar	IV ;
avannaanukar	IV ;
avannaarsuanukar	IV ;
avannaasar	IV ;
avannaasaannguar	IV ;
avaqqup	IV ;
avaqqup	TV ;
avaqqutsi	IV ;
avaqqutsisar	IV ;
avaqqutsor	IV ;
avarrallap	IV ;
avaser	IV ;
avasersor	TV ;
avaser	XTiXmorf ;
avasialup	IV ;
avasip	XIiXmorf ;
avasissoor	IV ;
avasiup	TV ;
avassila	IV ;
avataler	XIiXmorf ;
avatalior	IV ;
avatangerluinnar	TV ;
avatangersor	TV ;
avatanger	TV ;
avatanger	XTiXmorf ;
avatangii	IV ;
avatangiup	IV ;
avataritip	IV ;
avatarler	XIiXmorf ;
avatarpoor	IV ;
avatarpoortip	TV ;
avatarpaar	IV ;
avatarpaartip	TV ;
avatarser	XTiXmorf ;
avatartaler	TV ;
avatartaler	XIiXmorf ;
avatassi	IV ;
avatikkaar	IV ;
avatimmip	IV ;
avatimmip	TV ;
avatissarsi	IV ;
avatissaarsi	IV ;
avatissaarup	IV ;
avatser	IV ;
avatsi	IV ;
avatsisaar	IV ;
avatsiup	TV ;
avattap	IV ;
avattaatig	TVschwa ;
avataajar	IV ;
avataar	IV ;
avataarser	IV ;
avataarsualiar	IV ;
avataartaar	IV ;
avataarup	IV ;
avataasaler	TV ;
avataasaliup	TV ;
avataasior	IV ;
avataasiuup	TV ;
avataatigoor	IV ;
averor	IV ;
averrula	IV ;
averrulasorsuu	IV ;
averrullap	IV ;
averuala	IV ;
averuser	IV ;
aviffig	TVschwa ;
avigasuar	IV ;
avigaanukar	IV ;
aviiseer	IV ;
aviisilior	IV ;
aviisiliortunngor	IV ;
aviisiliortuu	IV ;
aviisisi	IV ;
avikkuma	IV ;
avikkuma	TV ;
aviler	XIiXmorf ;
aviliariip	XIPXmorf ;
aviliar	TVschwa ;
avilor	IV ;
avilortaaser	TV ;
aviluala	IV ;
avilualaar	IV ;
avilualaarpalup	IV ;
avilualaartitsi	IV ;
aviluar	IV ;
aviluarpalup	IV ;
avinnerlup	TV ;
avinneru	IV ;
avinngarup	XItX ;
avior	IV ;
aviortitsi	IV ;
avior	TV ;
avip	IV ;
avip	TV ;
avip	XIiXmorf ;
avip	XTPXmorf ;
avissi	IV ;
avississup	TV ;
avissi	TV ;
avissivig	TVschwa ;
avissutig	TVschwa ;
avissaa	IV ;
avissaaqqup	IV ;
avissaar	IV ;
avissaartip	TV ;
avissaartiter	TV ;
avissaartitsi	IV ;
avissaar	TV ;
avissaarutig	TVschwa ;
avissaarutaa	IV ;
avitip	TV ;
avitsi	IV ;
avittaasior	IV ;
aviu	IV ;
aviusi	IV ;
aviutitsi	IV ;
aviu	XIPXmorf ;
avoqqaarlerajup	IV ;
avoqqaarler	XIiXmorf ;
avoqqaartuutig	TVschwa ;
avoqqaar	TVschwa ;
avu	IV ;
avungaannar	IV ;
avunnar	IV ;
avunnaa	IV ;
avunnaap	TV ;
avusup	IV ;
avusuutig	TVschwa ;
avuunaqqup	IV ;
avaaginnip	IV ;
avaaginnitar	IV ;
avaag	TVschwa ;
avaakallap	IV ;
avaakallatsip	TV ;
avaakallaap	TV ;
avaakallaassi	IV ;
avaakallaatig	TVschwa ;
avaakallaatsip	TV ;
avaala	IV ;
avaalaqissiar	IV ;
avaala	TV ;
avaallap	IV ;
avaallap	TV ;
avaalaar	IV ;
avaalaartor	IV ;
avaalaartortuar	TV ;
avaalaartor	TV ;
avaalaartuar	TV ;
avaalaar	TV ;
avaannar	IV ;
avaanngug	TVschwa ;
avaanngu	IV ;
avaanngunar	IV ;
avaanngunarsi	IV ;
avaanngup	IV ;
avaanngusup	IV ;
avaannguup	XTuteXmorf ;
avaannguussi	IV ;
avaar	IV ;
avaarrallap	IV ;
avaartip	TV ;
avaar	TV ;
avaartaa	IV ;
avaartaasior	IV ;
avaarunnarsi	IV ;
avaarunnarsivip	IV ;
avaarunnarsivip	XIiXmorf ;
avaarup	TV ;
avaarussi	IV ;
avaassor	TV ;
avaassui	IV ;
bakteriaqanngilluinnar	IV ;
ballastilersor	IV ;
ballastilersor	TV ;
bananitor	IV ;
bankor	IV ;
batteriiler	TV ;
batteriiverup	IV ;
bibliotekariu	IV ;
biileerniar	IV ;
biiler	IV ;
biilertip	IV ;
biiler	XIiXmorf ;
biilileri	IV ;
biilisi	IV ;
bilitsi	IV ;
bilitsileri	IV ;
bilitsilerisuu	IV ;
bilitsisi	IV ;
bilitsisiniar	IV ;
bilitsisisoqarsinnaa	IV ;
billarder	IV ;
bingor	IV ;
bingortitsi	IV ;
bingortitsisar	IV ;
biskoppinngortip	TV ;
biskoppinngortitsi	IV ;
biskoppiu	IV ;
blåkorsiu	IV ;
borgmesterinngor	IV ;
borgmesterinngortip	TV ;
borgmesteriu	IV ;
brugsenimukar	IV ;
busser	IV ;
bussertartuu	IV ;
byggelederiu	IV ;
børster	TV ;
baaliar	IV ;
baaliar	TV ;
canadamukar	IV ;
cementilior	IV ;
censoriu	IV ;
ceruttitor	IV ;
chaufføriu	IV ;
cigarettitor	IV ;
computerer	IV ;
cykler	XIiXmorf ;
Daneborgimukar	IV ;
danmarkiliar	IV ;
danmarkimukar	IV ;
danskerpaluttunngortip	TV ;
danskisoor	IV ;
demokratiu	IV ;
departementschefiu	IV ;
diagrammilior	IV ;
direktøriu	IV ;
doktorinngor	IV ;
doktorinngorniutig	TVschwa ;
dumper	IV ;
duplikerer	TV ;
duplikerii	IV ;
eequja	IV ;
eer	IV ;
eernar	IV ;
eersior	IV ;
eertalior	IV ;
eertarpalup	IV ;
eer	TVschwa ;
eertaap	IV ;
eertaap	XItsXmorf ;
eertaatsiar	IV ;
eertaatsuu	IV ;
eqaller	XIiXmorf ;
eqalliarajup	IV ;
eqalliar	IV ;
eqalugarniar	IV ;
eqalugaarsunnukar	IV ;
eqalunniar	IV ;
eqalunniartip	IV ;
eqalup	IV ;
eqalussi	IV ;
eqalussiniar	IV ;
eqalussior	IV ;
eqalussuanngu	IV ;
eqalussuar	IV ;
eqalussuarniar	IV ;
eqalussuarniutissarsi	IV ;
eqar	IV ;
eqartanger	IV ;
eqartiller	XIiXmorf ;
eqartilup	IV ;
eqartip	IV ;
eqar	TVschwa ;
eqartaarup	IV ;
eqatalaar	IV ;
eqatalaartig	TVschwa ;
eqeer	IV ;
eqeerluar	IV ;
eqeersar	TV ;
eqeersimaar	IV ;
eqeersimaarluar	IV ;
eqeersimaartuu	IV ;
eqeersoor	IV ;
eqeersuummi	IV ;
eqeersuummisaar	IV ;
eqeersaa	IV ;
eqeersaasar	IV ;
eqeersaasuu	IV ;
eqeersaataa	IV ;
eqeqqormip	TV ;
eqeri	IV ;
eqeruloor	IV ;
eqeruloor	TV ;
eqiagiinnar	TV ;
eqiagiler	TV ;
eqiag	TVschwa ;
eqianar	IV ;
eqianni	IV ;
eqiap	IV ;
eqiasuaqsuu	IV ;
eqiasuip	XItsXmorf ;
eqiasup	IV ;
eqiasuttuu	IV ;
eqiatitaar	IV ;
eqiatsap	IV ;
eqiatsaap	TV ;
eqiattortu	IV ;
eqig	IVschwa ;
eqiiallannar	IV ;
eqiiallap	IV ;
eqiiallaatig	TVschwa ;
eqiinga	IV ;
eqiingasoor	IV ;
eqiingasuu	IV ;
eqiingasaar	IV ;
eqi	IV ;
eqikkar	IV ;
eqikkar	TV ;
eqikkaa	IV ;
eqiller	XIiXmorf ;
eqilup	IV ;
eqima	IV ;
eqimarrap	XIPXmorf ;
eqimattakkuutaar	XIPXmorf ;
eqimattanngor	TV ;
eqimmap	IV ;
eqimmattorsuu	XIPXmorf ;
eqinga	IV ;
eqingasoor	IV ;
eqingasulip	IV ;
eqinnaallior	IV ;
eqinnaap	IV ;
eqinnaap	XItsXmorf ;
eqinnaaser	IV ;
eqinnaasaar	IV ;
eqip	IV ;
eqip	TV ;
eqisalulp	IV ;
eqisalunniiartip	IV ;
eqisalup	IV ;
eqisalutsip	IV ;
eqisar	IV ;
eqisartitsi	IV ;
eqisimiar	TV ;
eqisimisser	IV ;
eqisimissiup	TV ;
eqisimmap	IV ;
eqisimaar	IV ;
eqisimaarrap	XIPXmorf ;
eqisimaarrattorsuu	XIPXmorf ;
eqisimaar	TV ;
eqissup	IV ;
eqissup	TV ;
eqissussi	IV ;
eqissussip	TV ;
eqitarsor	IV ;
eqiterfig	TVschwa ;
eqiteri	IV ;
eqiter	IV ;
eqiterup	IV ;
eqiterutitaar	IV ;
eqiter	XTiXmorf ;
eqitip	TV ;
eqitsi	IV ;
eqittaa	IV ;
eqittaannartagaa	IV ;
eqitaaginnar	TV ;
eqitaar	IV ;
eqitaar	TV ;
eqoqip	TV ;
eqoqittaa	IV ;
eqoriip	XItsXmorf ;
eqoriitsuu	IV ;
eqor	IV ;
eqortip	TV ;
eqortor	IV ;
eqor	TV ;
eqqag	TVschwa ;
eqqakattar	TVschwa ;
eqqanaq	K ;
eqqanar	IV ;
eqqanaar	IV ;
eqqanaarsar	IV ;
eqqanaarsaap	TV ;
eqqanaartor	IV ;
eqqanaar	TV ;
eqqar	IV ;
eqqarleriip	XIPXmorf ;
eqqarleriiaar	IV ;
eqqarler	TVschwa ;
eqqarlimaar	IV ;
eqqarlimaar	TV ;
eqqarlimaarutig	TVschwa ;
eqqarpalup	IV ;
eqqarsallaqqip	XIiXmorf ;
eqqarsarfissaqartitaa	IV ;
eqqarsarfissaqartitaajumagaluar	IV ;
eqqarsarfissaqartitaajuma	IV ;
eqqarsarfissarititaa	IV ;
eqqarsarfissaatitaa	IV ;
eqqarsar	IV ;
eqqarsarluar	IV ;
eqqarsar	TVschwa ;
eqqarsaatersor	IV ;
eqqarsaatigeqqissaar	TV ;
eqqarsaatigeqqaar	TV ;
eqqarsaatigiinnar	TV ;
eqqarsaatigilluaqqaar	TV ;
eqqarsaatigilluar	TV ;
eqqarsaatiginiarallar	TV ;
eqqarsaatiginiar	TV ;
eqqarsaatigisar	TV ;
eqqarsaatig	TVschwa ;
eqqarsaatissip	TV ;
eqqarsaataagaluar	IV ;
eqqarsaataa	IV ;
eqqarsaataannarsor	IV ;
eqqarsaataannaa	IV ;
eqqartip	TV ;
eqqartoraluar	TV ;
eqqartor	TV ;
eqqartor	TVschwa ;
eqqartui	IV ;
eqqartukula	TV ;
eqqartuler	TVschwa ;
eqqartuler	XTiXmorf ;
eqqartunnaagar	TVschwa ;
eqqartuup	XTuteXmorf ;
eqqartuussassanngor	IV ;
eqqartuussassaa	IV ;
eqqartuusseqataa	IV ;
eqqartuusseqataasar	IV ;
eqqartuussi	IV ;
eqqartuussisuu	IV ;
eqqartuussivimmukar	IV ;
eqqartuussaa	IV ;
eqqartuussaatip	TV ;
eqqartuutip	TV ;
eqqartuutitip	TV ;
eqqar	TV ;
eqqasukkuma	IV ;
eqqasup	IV ;
eqqasuup	TV ;
eqqasuutig	TVschwa ;
eqqatsannar	IV ;
eqqatsap	IV ;
eqqatsaap	TV ;
eqqatsaatig	TVschwa ;
eqqattaa	IV ;
eqqattaar	IV ;
eqqattaar	TVschwa ;
eqqer	IV ;
eqqiar	IV ;
eqqiar	TV ;
eqqilior	IV ;
eqqiluillisaar	IV ;
eqqiluip	XItsXmorf ;
eqqiluisaar	IV ;
eqqiluisaartuu	IV ;
eqqiluitsuu	IV ;
eqqinip	IV ;
eqqip	IV ;
eqqip	XIiXmorf ;
eqqissi	IV ;
eqqissiniar	IV ;
eqqissisi	IV ;
eqqissisimatitaa	IV ;
eqqissisimaar	IV ;
eqqissisimaarniar	IV ;
eqqissisip	TV ;
eqqissisaa	IV ;
eqqissisaajartor	IV ;
eqqissiveerup	IV ;
eqqissiveqatig	TVschwa ;
eqqissiviitsunngor	IV ;
eqqissiviitsunngortip	TV ;
eqqissiviitsunngortitaa	IV ;
eqqissiviitsuu	IV ;
eqqissivip	XIiXmorf ;
eqqissivissioqatigiip	IV ;
eqqissivissioqatigiip	XIPXmorf ;
eqqissivissioqatig	TVschwa ;
eqqissaar	IV ;
eqqissaarunnaar	IV ;
eqqitsumukar	IV ;
eqqiaasuu	IV ;
eqqoriarniup	XTPXmorf ;
eqqoriarniutig	TVschwa ;
eqqoriarniaannaraluar	TV ;
eqqoriarniaannar	TV ;
eqqoriar	TV ;
eqqor	IV ;
eqqoriaaginnar	IV ;
eqqoriaa	IV ;
eqqoriaanerinnaa	IV ;
eqqoriaannar	TV ;
eqqorluar	IV ;
eqqorluinnar	IV ;
eqqorluinnar	TV ;
eqqormip	IV ;
eqqornaveeqqutig	TVschwa ;
eqqornaveertip	TV ;
eqqorneqaatig	TVschwa ;
eqqorniaa	IV ;
eqqorniaasar	IV ;
eqqorsor	IV ;
eqqorsup	IV ;
eqqortip	IV ;
eqqortip	TV ;
eqqortuunerar	TV ;
eqqortuuneraa	IV ;
eqqor	TV ;
eqqortaalior	IV ;
eqqoruminar	IV ;
eqqoruminaap	XItsXmorf ;
eqqugassaa	IV ;
eqquigajup	IV ;
eqquigaluar	IV ;
eqqui	IV ;
eqquiniar	IV ;
eqquiniaa	IV ;
eqquiniaasar	IV ;
eqquiniaasitsi	IV ;
eqquisar	IV ;
eqquissagaluar	IV ;
eqquisaannar	IV ;
eqqukkiartor	TV ;
eqquma	IV ;
eqqumaniarfig	TVschwa ;
eqqumaniar	IV ;
eqqumasi	IV ;
eqqumatip	TV ;
eqquma	TV ;
eqqumiiginartip	TV ;
eqqumiig	TVschwa ;
eqqumiillior	IV ;
eqqumiiluallap	IV ;
eqqumiip	XItsXmorf ;
eqqumiitsulior	IV ;
eqqumiitsuliortuu	IV ;
eqqumiitsuu	IV ;
eqqumiivip	XIiXmorf ;
eqqumma	IV ;
eqqummarip	XIiXmorf ;
eqqummarissuu	IV ;
eqqummaarip	XIiXmorf ;
eqqummaarissuu	IV ;
eqqup	TV ;
eqqusarniar	IV ;
eqqussi	IV ;
eqqussor	TV ;
eqqussui	IV ;
eqqussaa	IV ;
eqquukkiartor	IV ;
eqquup	IV ;
eqquup	TV ;
eqquusimaar	IV ;
eqquutip	TV ;
eqquutitip	TV ;
eqqaa	IV ;
eqqaakulup	IV ;
eqqaama	IV ;
eqqaamajuminar	IV ;
eqqaamajuminaap	XItsXmorf ;
eqqaamajuminaatsip	TV ;
eqqaamaneqarunar	IV ;
eqqaamaniar	TV ;
eqqaamannip	IV ;
eqqaamannissinnaa	IV ;
eqqaamannissinnaajunnaar	IV ;
eqqaamasalersaar	IV ;
eqqaamassutig	TVschwa ;
eqqaamasaarup	IV ;
eqqaama	TV ;
eqqaamior	TVschwa ;
eqqaanar	IV ;
eqqaaniar	TV ;
eqqaaniutig	TVschwa ;
eqqaaniaa	IV ;
eqqaannar	TV ;
eqqaap	TV ;
eqqaaqqajar	TV ;
eqqaaqqajaa	TV ;
eqqaariinnar	TV ;
eqqaarsup	IV ;
eqqaar	TVschwa ;
eqqaasar	IV ;
eqqaasior	TV ;
eqqaasip	TV ;
eqqaasissutig	TVschwa ;
eqqaasitsi	IV ;
eqqaasitsissutig	TVschwa ;
eqqaasiui	IV ;
eqqaassi	IV ;
eqqaassutig	TVschwa ;
eqqaassaar	TV ;
eqqaassaavip	TV ;
eqqaasaar	TV ;
eqqaa	TV ;
equi	IV ;
equip	XIiXmorf ;
equ	IV ;
equjuar	IV ;
equnga	IV ;
equngalaar	IV ;
equngasoor	IV ;
equngaar	IV ;
equsoor	IV ;
equsoortip	TV ;
equsaar	IV ;
equsaartip	TV ;
equummi	IV ;
equummisar	IV ;
equutissiarsi	IV ;
equutissiarsiniar	IV ;
eqaalli	IV ;
eqaallisar	IV ;
eqaallisar	TV ;
eqaannersaa	IV ;
eqaap	XItsXmorf ;
eqaar	IV ;
eqaarsaallaqqip	XIiXmorf ;
eqaarsaallaqqissuu	IV ;
eqaarsaar	IV ;
eqaarsaartartuu	IV ;
eqaarsaartitsi	IV ;
erfagiup	TV ;
erfagiussi	IV ;
erfagiussaa	IV ;
erfala	IV ;
erfalalaar	IV ;
erfalasorsi	IV ;
erfalasuler	XIiXmorf ;
erfalasulisar	IV ;
erfalasulisartuu	IV ;
erfali	IV ;
erfalior	IV ;
erfalaar	IV ;
erfar	IV ;
erfi	IV ;
erfaap	IV ;
eriaginar	IV ;
eriaginartuu	IV ;
eriagisariaqaraluar	IV ;
eriagisariaqaraluar	TV ;
eriag	TVschwa ;
erinagip	XIiXmorf ;
erinagissuu	IV ;
erinalersuutig	TVschwa ;
erinaller	XIiXmorf ;
erinalup	IV ;
erinaqatigiip	XIPXmorf ;
erinarlup	IV ;
erinarsoqatigiip	IV ;
erinarsoqatigiip	XIPXmorf ;
erinarsoqattaar	IV ;
erinarsor	IV ;
erinarsortartuu	IV ;
erinarsortitsi	IV ;
erinarsortitsisuu	IV ;
erinarsuutig	TVschwa ;
erineersaar	IV ;
erineersaarutig	TVschwa ;
erinig	TVschwa ;
eriniikkusersor	TV ;
erini	IV ;
erinikkup	TV ;
erinikkussi	IV ;
erininaq	K ;
erininar	IV ;
erininarsi	IV ;
erininarsivip	XIiXmorf ;
erininat	K ;
erininavip	XIiXmorf ;
erinisup	IV ;
erinisuup	IV ;
erinitsajui	IV ;
erinitsajuip	XItsXmorf ;
erinitsap	IV ;
erinitsavip	IV ;
erinitsavip	XIiXmorf ;
erinitsaap	XTuteXmorf ;
erinitsaarluer	IV ;
erinitsaativip	XTiXmorf ;
eriniusaar	IV ;
erinner	IV ;
erinnersaallaqqip	XIiXmorf ;
erinnersaar	IV ;
erinnersaarutig	TVschwa ;
erinnior	IV ;
erinniortuu	IV ;
erinnior	TV ;
erip	TV ;
erip	XIiXmorf ;
erisar	IV ;
erisar	TV ;
erisassi	IV ;
erisassi	TV ;
erissaar	IV ;
erisaalior	IV ;
erisaartaar	IV ;
erisaasior	IV ;
erisaatilior	IV ;
erisaatitaar	IV ;
eritsap	IV ;
eritsarip	XIiXmorf ;
eritsarissi	IV ;
eritsarivip	XIiXmorf ;
eritsaser	IV ;
eritser	TV ;
erivilluar	IV ;
erivip	XIiXmorf ;
erivisar	TV ;
erivissii	TV ;
erivitip	TV ;
erlap	IV ;
erlaveer	TV ;
erlavissor	IV ;
erlavissor	TV ;
erler	TV ;
erler	TVschwa ;
erliataar	IV ;
erligisaarup	IV ;
erlig	TVschwa ;
erliguup	IV ;
erliguup	TV ;
erliguussi	IV ;
erlikkeer	IV ;
erlikker	XTiXmorf ;
erlinnar	IV ;
erlinnartorsior	IV ;
erlinnartuutig	TVschwa ;
erlip	IV ;
erlippanip	IV ;
erlip	TV ;
erloqi	IV ;
erloqinar	IV ;
erloqisip	TV ;
erloqisitsi	IV ;
erloqissutig	TVschwa ;
erloqissutaa	IV ;
erloqqunnar	IV ;
erloqqup	TV ;
erloqqussi	IV ;
erloqqutig	TVschwa ;
erlunnguummi	IV ;
erlunnguumminar	IV ;
erlunnguummisaar	IV ;
erlaar	IV ;
erlaarsi	IV ;
erlaarsisar	IV ;
erlaartiter	IV ;
erlaar	TV ;
ermalitser	IV ;
ermalitser	XTiXmorf ;
ermiaqqaanni	IV ;
ermikkiartor	IV ;
ermikkiartorniar	IV ;
ermikkuma	IV ;
ermior	IV ;
ermip	IV ;
ermip	TV ;
ermittarniar	IV ;
ermup	IV ;
ermuseeraarniar	IV ;
ermutig	TVschwa ;
ermuttorsuu	XIPXmorf ;
ernannartaar	IV ;
ernannaarup	IV ;
ernar	IV ;
ernarpalup	IV ;
erneqqajaa	IV ;
erner	IV ;
ernerluinnar	IV ;
ernerlaa	IV ;
ernertu	IV ;
erner	TV ;
erner	TVschwa ;
ernertaap	TV ;
ernertaar	IV ;
ernertaar	TVschwa ;
ernerulluar	IV ;
erngalitser	XTiXmorf ;
erngar	IV ;
erngarpalup	IV ;
erngasup	IV ;
ernger	IV ;
ernger	TV ;
erngiinnaar	IV ;
erngueeraarniar	IV ;
erngumag	TVschwa ;
ernguma	IV ;
erngumanar	IV ;
erngumanartoqarsinnaa	IV ;
erngumanaallisaa	IV ;
erngumaqqu	TV ;
erngumassutig	TVschwa ;
erngumatsap	IV ;
ernguma	TV ;
erngummap	TV ;
erngup	IV ;
ernguseeraarniar	IV ;
erngutaqqiutig	TVschwa ;
erngutaqqiutitaar	IV ;
erngutartaar	IV ;
erngutseri	IV ;
erniar	TVschwa ;
ernigaluar	IV ;
erniinnaar	IV ;
erni	IV ;
erninerlup	IV ;
ernioqqip	XIiXmorf ;
ernioqqissitaa	IV ;
ernior	IV ;
ernisuaqsuu	IV ;
ernisuip	XItsXmorf ;
ernisup	IV ;
ernisussior	IV ;
ernisussior	TV ;
ernitsorlup	IV ;
erniu	IV ;
ernumag	TVschwa ;
ernuma	IV ;
ernumanar	IV ;
ernumanartoqarsinnaa	IV ;
ernumanaallisaa	IV ;
ernumassutig	TVschwa ;
ernumatsap	IV ;
ernumatsavip	XIiXmorf ;
ernumatsaap	TV ;
ernuma	TV ;
ernummap	TV ;
ernummatig	TVschwa ;
ernutaqqiutig	TVschwa ;
ernutartaar	IV ;
errorsar	IV ;
errorsi	IV ;
errorsisar	IV ;
errorsissup	XTuteXmorf ;
errorsissussi	IV ;
errorsivissi	IV ;
errortoriar	TV ;
errortor	IV ;
errortor	TV ;
error	TV ;
errui	IV ;
erruissutisi	IV ;
errup	XTuteXmorf ;
errutivip	XTPXmorf ;
erruuser	IV ;
ersalip	IV ;
ersalitsivip	XIiXmorf ;
ersanga	IV ;
ersap	IV ;
ersarilluinnar	IV ;
ersarip	XIiXmorf ;
ersarissar	TV ;
ersarissaa	IV ;
ersarmip	TV ;
ersarunngu	IV ;
ersarunngutig	TVschwa ;
ersaruser	XTiXmorf ;
ersarutser	TV ;
erseqqarilluar	IV ;
erseqqarilluinnar	IV ;
erseqqarip	XIiXmorf ;
erseqqarissi	IV ;
erseqqarissivip	XIiXmorf ;
erseqqilluinnar	IV ;
erseqqip	XIiXmorf ;
erseqqissar	TV ;
erseqqissi	IV ;
erseqqissisip	TV ;
erseqqissivip	XIiXmorf ;
erseqqissaa	IV ;
erseqqissaatiginiar	TV ;
erseqqissaatig	TVschwa ;
erseratar	IV ;
erser	IV ;
ersernerlup	IV ;
ersernerlussi	IV ;
ersersar	TV ;
ersersilluar	TV ;
ersersip	TV ;
ersersaa	IV ;
ersersaasar	IV ;
erser	TV ;
erserunnarsigaluar	IV ;
erserunnarsi	IV ;
erser	XTiXmorf ;
ersiarsup	IV ;
ersig	TVschwa ;
ersigunnaar	IV ;
ersi	IV ;
ersikkunnaar	IV ;
ersinaq	K ;
ersinar	IV ;
ersinartulersaar	IV ;
ersinneerup	IV ;
ersior	IV ;
ersiortip	TV ;
ersiortitsi	IV ;
ersip	IV ;
ersip	XItsXmorf ;
ersisaari	IV ;
ersisaarisar	IV ;
ersisaarniar	TV ;
ersisaar	TV ;
ersisaarutigiinnar	TV ;
ersisaarutig	TVschwa ;
ersitoorsuu	IV ;
ersitsap	IV ;
ersitsavip	XIiXmorf ;
ersitsaap	IV ;
ersitsaap	TV ;
ersituallaar	IV ;
ersitu	IV ;
ersiummer	IV ;
ersiup	TV ;
ersiutig	TVschwa ;
ersor	IV ;
ersorsi	IV ;
ersor	TV ;
ersukker	IV ;
ersukkersor	IV ;
ersukkiup	TV ;
ersukkiussi	IV ;
ersulleraap	IV ;
ersulligaap	XIPXmorf ;
ersup	IV ;
ersup	TV ;
ersussi	IV ;
ersuusior	IV ;
ersuussi	IV ;
ersaap	XItsXmorf ;
ersaar	IV ;
ersaar	TV ;
ersaartaap	IV ;
ersaartaap	TV ;
eruilluar	IV ;
eruip	IV ;
eruisar	TV ;
eruissii	TV ;
eruitip	TV ;
erullup	IV ;
erusser	TV ;
erussaar	IV ;
Europamiorpaluttunngortip	TV ;
Europamukar	IV ;
fabrikkilior	IV ;
faglæreriu	IV ;
farsilior	IV ;
feeriar	IV ;
fester	IV ;
filmeriar	IV ;
filmer	IV ;
filmiliar	TVschwa ;
filmilior	IV ;
fiskeskipperiu	IV ;
fjernsyner	IV ;
formandiu	IV ;
forstanderissarsior	IV ;
forstanderiu	IV ;
franskisoor	IV ;
frimærkiler	TV ;
frimærkilii	IV ;
frokoster	IV ;
fuldmægtigiu	IV ;
galvaniseerigaa	IV ;
generaldirektøriu	IV ;
generaliu	IV ;
gigteqartaler	XIiXmorf ;
golfer	IV ;
guitarer	IV ;
guutipilussior	IV ;
halfbackiu	IV ;
helikopterer	IV ;
hertugiu	IV ;
hester	IV ;
hiister	IV ;
horaartor	IV ;
horaarutig	TVschwa ;
hundrederiar	IV ;
huaartor	IV ;
høvdingiu	IV ;
håndbolder	IV ;
ianga	IV ;
iangasoor	IV ;
iangavallaar	IV ;
iasilaar	IV ;
iasoor	IV ;
iatap	IV ;
iffap	IV ;
iffarip	XIiXmorf ;
iffarissaar	IV ;
iffaser	IV ;
iffaser	XTiXmorf ;
iffiakatap	IV ;
iffiakatavip	IV ;
iffiar	IV ;
iffiarsi	IV ;
iffiarsiniar	IV ;
iffiartor	IV ;
iffiarup	IV ;
iffikkiar	IV ;
iffiorfikkoor	TV ;
iffior	IV ;
iffiortuu	IV ;
iffip	IV ;
iffittorsuu	IV ;
iffiussuulluar	IV ;
iffiussuup	XIPXmorf ;
iffaa	TV ;
iga	IV ;
igajartor	IV ;
igajartorniar	IV ;
igalassersor	TV ;
igalassersui	IV ;
igalassersuisar	IV ;
igalasser	TV ;
igalassior	IV ;
igalassiup	TV ;
igaler	XIiXmorf ;
igalikumukar	IV ;
igalaajar	IV ;
igalaajar	TV ;
igalaaler	TV ;
igalaalior	IV ;
igalaaminilior	IV ;
igalaasar	IV ;
igalaaviar	IV ;
igalaaviar	TV ;
iganiar	IV ;
igasar	IV ;
igasuu	IV ;
iga	TV ;
igeeqqar	TV ;
igeeqqaa	IV ;
igerpallap	IV ;
iggap	XTuteXmorf ;
iggarip	XIiXmorf ;
iggarissaar	IV ;
iggaser	IV ;
iggasersor	IV ;
iggassi	IV ;
iggassisar	IV ;
iggavig	TVschwa ;
iggeerup	IV ;
iggeri	IV ;
iggerisuu	IV ;
iggersaar	IV ;
iggiarip	IV ;
iggiarip	XIiXmorf ;
iggiarissariar	IV ;
iggiarissar	IV ;
iggiarluler	XIiXmorf ;
iggiarlup	IV ;
iggigisimaannar	IV ;
iggiinga	IV ;
iggiingaannar	IV ;
iggiinngar	IV ;
iggip	IV ;
iggip	TV ;
iggiser	XIiXmorf ;
iggiser	XTiXmorf ;
iggisig	TVschwa ;
iggisii	IV ;
iggissi	IV ;
iggissaa	IV ;
iggiaar	TV ;
iggiaarup	IV ;
iggulluar	IV ;
iggup	TV ;
igi	IV ;
igikkuma	TV ;
igimar	TV ;
igimartaar	IV ;
iginasaar	TV ;
iginnerusisar	IV ;
iginnerutaarup	IV ;
iginniarfimmukar	IV ;
iginniar	IV ;
iginnilior	IV ;
igip	IV ;
igip	TV ;
igisar	IV ;
igisoor	IV ;
igisoortip	TV ;
igitassaa	IV ;
igitassaannaa	IV ;
igitip	TV ;
igitser	TV ;
igitsii	IV ;
igitsii	TV ;
igitsi	IV ;
igitsisar	IV ;
igitsisaannar	IV ;
igitsivig	TVschwa ;
igitaa	IV ;
igiula	IV ;
ig	TVschwa ;
igunalaar	IV ;
igunar	IV ;
igunarnilaar	IV ;
igunarnip	IV ;
igunarnip	XItsXmorf ;
igunarser	TV ;
igunarsi	IV ;
igup	TV ;
igutsi	IV ;
igutsisar	IV ;
iguutaarup	IV ;
iguutaarutivip	XIiXmorf ;
igaannar	TV ;
igaar	IV ;
igaarsunnip	XItsXmorf ;
igaartor	IV ;
igaasariar	IV ;
igaasar	IV ;
igaassaqaraluar	IV ;
iigar	IV ;
iigarter	IV ;
iigartip	TV ;
iigup	TV ;
iigussaa	IV ;
iikaja	IV ;
iikajataar	IV ;
iikkersor	TV ;
iikkersui	IV ;
iikker	XTiXmorf ;
iillarip	XIiXmorf ;
iilaa	IV ;
iimi	IV ;
iiminar	IV ;
iimisaar	IV ;
iinasor	TVschwa ;
iingagiunnaar	TV ;
iingagivallaar	TV ;
iingag	TVschwa ;
iinga	IV ;
iingala	IV ;
iiorar	TV ;
iioraa	IV ;
iioraasip	TV ;
iipiliilatsi	IV ;
iipilinnap	IV ;
iipilisi	IV ;
iipilitor	IV ;
iippigisaarutivip	XIiXmorf ;
iisaqusap	IV ;
iisartagassip	TV ;
iisartakker	XTiXmorf ;
iisassarsi	IV ;
iisasseri	IV ;
iisi	IV ;
iisilluar	IV ;
iisi	TV ;
iisorniuser	IV ;
iisorniusersor	IV ;
iisaarser	IV ;
iitannar	IV ;
iitap	IV ;
iitsallarip	XIiXmorf ;
iitsiveerup	IV ;
ii	TV ;
iivangkiiliulersaar	IV ;
iivangkilisti	IV ;
iiaatsiaar	XIPXmorf ;
ikajuuser	TV ;
ikajuuser	XTiXmorf ;
ikajuutaarser	IV ;
ikakkajup	IV ;
ikakkiar	IV ;
ikaler	XIiXmorf ;
ikali	IV ;
Ikamiunukar	IV ;
ikanneruler	XIiXmorf ;
ikap	IV ;
ikaqasiup	TV ;
ikaqatig	TVschwa ;
ikaqataa	IV ;
ikarasakkoor	IV ;
ikarasaliakkoor	IV ;
ikarasanip	IV ;
ikarasaqqup	TV ;
ikarasaqqutsi	IV ;
ikasar	IV ;
ikasarpalup	IV ;
ikasartuaannar	IV ;
ikasaannar	IV ;
ikasaatig	TVschwa ;
ikatip	TV ;
ikatitsi	IV ;
ikatsitsi	IV ;
ikatu	IV ;
ikerasakkoor	IV ;
ikerasanip	IV ;
ikerasannukar	IV ;
ikerasaqqup	TV ;
ikerasaqqutsi	IV ;
ikerasassuarmukar	IV ;
ikerasaarsunnukar	IV ;
ikeratser	IV ;
ikeratsiar	IV ;
ikerinnarsior	IV ;
ikeritsu	IV ;
iker	IV ;
ikernguerup	IV ;
ikernguser	XTiXmorf ;
ikernuerup	IV ;
ikernussersor	TV ;
ikernusser	XTiXmorf ;
ikerpar	IV ;
ikerparter	IV ;
ikerpasip	XIiXmorf ;
ikersior	IV ;
ikersior	TV ;
ikersip	XItX ;
ikersisimalaar	IV ;
ikersisimalaar	TV ;
ikersisimatilaar	TV ;
ikersisimatip	TV ;
ikertu	IV ;
ikiagoor	IV ;
ikiagaa	IV ;
ikiala	IV ;
ikialitsip	IV ;
ikianga	IV ;
ikiaquser	TV ;
ikiariissitaar	IV ;
ikiarissaar	IV ;
ikiar	IV ;
ikiaroor	IV ;
ikiaroornar	IV ;
ikiaroornartuer	IV ;
ikiaroornartuerniar	IV ;
ikiaroornartuleri	IV ;
ikiaroortuaannar	IV ;
ikiarsi	IV ;
ikiar	TV ;
ikiar	TVschwa ;
ikiffigiinnar	TV ;
ikiffig	TVschwa ;
ikiffissarsi	IV ;
ikiffissarsiniar	IV ;
ikiffissaarup	IV ;
ikigip	IV ;
ikigip	XIiXmorf ;
ikigissaar	IV ;
ikig	TVschwa ;
iki	IV ;
ikikilli	IV ;
ikikinaar	TV ;
ikikip	IV ;
ikikip	XItsXmorf ;
ikikkagaa	IV ;
ikikkartip	TV ;
ikikkar	TV ;
ikikkaa	IV ;
ikilersor	TV ;
ikilersui	IV ;
ikiler	TV ;
ikiliartor	XIPXmorf ;
ikiliartuinnar	IV ;
ikiligaa	IV ;
ikili	IV ;
ikilisip	TV ;
ikilissuu	IV ;
ikilliartor	XIPXmorf ;
ikilli	IV ;
ikillaa	IV ;
ikilulluinnar	IV ;
ikilup	IV ;
ikilutsip	IV ;
ikinerpalup	IV ;
ikinnerugaluar	IV ;
ikinneru	IV ;
ikinnerussuteqaraluar	IV ;
ikinngusisar	IV ;
ikinngutiffaarig	TVschwa ;
ikinngutigiip	XIPXmorf ;
ikinngutig	TVschwa ;
ikinngutikkuminar	IV ;
ikinngutiller	XTiXmorf ;
ikinngutimaar	TV ;
ikinngutinnerfig	TVschwa ;
ikinngutinner	IV ;
ikinngutinnersuu	IV ;
ikinngutinnersaarfig	TVschwa ;
ikinngutinnersaar	IV ;
ikinngutituar	TVschwa ;
ikinngutaa	IV ;
ikinngutaarup	IV ;
ikinaaqqup	TV ;
ikinaari	IV ;
ikinaar	TV ;
ikinaarunnaar	TV ;
ikioqqar	TV ;
ikioqqugaluar	IV ;
ikioqqu	IV ;
ikioqqutu	IV ;
ikioqqutuu	IV ;
ikioqqu	TV ;
ikioqutsi	IV ;
ikior	IV ;
ikiorser	XTiXmorf ;
ikiorsiisig	TVschwa ;
ikiorsiissutig	TVschwa ;
ikiorsiutaagallar	IV ;
ikiorsiutaa	IV ;
ikiortigiip	XIPXmorf ;
ikiortig	TVschwa ;
ikiortillior	IV ;
ikiortiserigaluar	TV ;
ikiortiserinnip	IV ;
ikiortiseri	TV ;
ikiortiser	TVschwa ;
ikiortissarsior	IV ;
ikiortissarsior	TV ;
ikiortissiup	TV ;
ikior	TV ;
ikiortaa	IV ;
ikiortaarup	IV ;
ikiortaasar	IV ;
ikioraa	IV ;
ikip	IV ;
ikippallaar	XIPXmorf ;
ikip	TV ;
ikip	XItsXmorf ;
ikisi	IV ;
ikisissup	TV ;
ikisorsuu	IV ;
ikitsi	IV ;
ikitsisisior	IV ;
ikitsisissarsior	IV ;
ikitsissup	TV ;
ikitsisuu	IV ;
ikitsisaa	IV ;
ikitsisaarniar	IV ;
ikittunnguakkuutaar	XIPXmorf ;
ikittunnguu	XIPXmorf ;
ikittaaser	TV ;
iki	TV ;
ikiueqqaar	IV ;
ikiugaa	IV ;
ikiuiartor	IV ;
ikiuigajup	IV ;
ikiuigajuttuu	IV ;
ikiui	IV ;
ikiuiniaqatigiip	IV ;
ikiuiniaqqissaar	IV ;
ikiuisar	IV ;
ikiuisaannar	IV ;
ikiuiumatu	IV ;
ikiuiumatuu	IV ;
ikiulup	IV ;
ikiulup	TV ;
ikiuluttaannar	IV ;
ikiuluttaannar	TV ;
ikiumagaluar	IV ;
ikiuma	IV ;
ikiupersaar	IV ;
ikiupersaar	TV ;
ikiupisisaar	IV ;
ikiupisisaar	TV ;
ikiuukkaluar	IV ;
ikiuukkumatu	IV ;
ikiuulluar	IV ;
ikiuunniarsarigaluar	IV ;
ikiuunniarsar	IVschwa ;
ikiuup	XIuteXmorf ;
ikiuuterujoor	IV ;
ikiuuterusaar	IV ;
ikiuutialup	IV ;
ikiuutikatap	IV ;
ikiuutikatavip	XIiXmorf ;
ikiuutikula	IV ;
ikiuutisi	IV ;
ikiuutitor	IV ;
ikiuuttuar	IV ;
ikiuutaa	IV ;
ikiuutaalluar	IV ;
ikiuutaalluarnerusinnaa	IV ;
ikkagisoor	TV ;
ikkag	TVschwa ;
ikkakujup	IV ;
ikkali	IV ;
ikkalisoor	IV ;
ikkanneriar	TV ;
ikkanniiar	TV ;
ikkannikkiartor	IV ;
ikkannip	IV ;
ikkap	IV ;
ikkappallaar	IV ;
ikkarliffig	TVschwa ;
ikkarlikkaluttuar	IV ;
ikkarlip	XItX ;
ikkarlisimajunnaar	IV ;
ikkarlisip	TV ;
ikkarlisaar	IV ;
ikkarlitsip	TV ;
ikkarluisap	IV ;
ikkarnar	IV ;
ikkarnaallap	IV ;
ikkarnaallariar	IV ;
ikkar	TVschwa ;
ikkaser	IV ;
ikkasaanngilaq	K ;
ikkatiginnip	IV ;
ikkatig	TVschwa ;
ikkatillii	IV ;
ikkattimukar	IV ;
ikkattunnguu	IV ;
ikkataa	IV ;
ikkeernar	IV ;
ikkeertor	IV ;
ikkiilli	IV ;
ikkiip	XItsXmorf ;
ikkillup	IV ;
ikkilup	IV ;
ikkinger	IV ;
ikkingersinnaa	IV ;
ikkingersoor	IV ;
ikkivigiinnar	TV ;
ikkivig	TVschwa ;
ikkivissarsi	IV ;
ikkivissaarup	IV ;
ikkuffig	TVschwa ;
ikkuffissarsi	IV ;
ikkuffissarsi	TV ;
ikkuffissaarup	IV ;
ikkuffissaarup	TV ;
ikkuller	XTiXmorf ;
ikkulluar	IV ;
ikkulluar	TV ;
ikkulup	IV ;
ikkulutsitsi	IV ;
ikkuluttuinnaa	IV ;
ikkulaar	IV ;
ikkulaartitsi	IV ;
ikkulaartuinnaa	IV ;
ikkunga	IV ;
ikkungalaar	IV ;
ikkup	IV ;
ikkup	TV ;
ikkussi	IV ;
ikkussor	TV ;
ikkussui	IV ;
ikkussuip	IV ;
ikkussaa	IV ;
ikkutiinnar	IV ;
ikkutiinnar	TV ;
ikkuttoor	IV ;
ikkuttoor	TV ;
ikkutaa	IV ;
ikkutaannaa	IV ;
ikkutaasar	IV ;
ikkaalup	IV ;
ikkaalutsitsi	IV ;
ikkaaluttuinnaa	IV ;
ikorfartor	TV ;
ikorfartui	IV ;
ikorfar	TV ;
ikorfiup	TV ;
ikorfiussaa	IV ;
ikorfaa	IV ;
ikor	IV ;
ikorsimaffiu	IV ;
ikorsimmavissi	IV ;
ikuala	IV ;
ikualasorsuu	IV ;
ikuallagussaa	IV ;
ikuallagaa	IV ;
ikuallaja	IV ;
ikuallajavallaar	IV ;
ikuallap	IV ;
ikuallap	TV ;
ikuallassaaser	TV ;
ikuallatsinneqarsinnaa	IV ;
ikuallatsip	TV ;
ikuallatsitsi	IV ;
ikuallattoor	IV ;
ikuallaa	IV ;
ikuallaap	IV ;
ikuallaar	IV ;
ikualaar	IV ;
ikuar	TV ;
ikugaa	IV ;
ikuller	XTiXmorf ;
ikulluar	IV ;
ikuma	IV ;
ikumajuar	IV ;
ikumajunnaar	IV ;
ikumajuaannar	IV ;
ikumalluar	IV ;
ikumap	IV ;
ikumatitsi	IV ;
ikumatitsisar	IV ;
ikummap	IV ;
ikummarip	XIiXmorf ;
ikummarissar	TV ;
ikummarissi	IV ;
ikummarissaar	IV ;
ikummarlup	IV ;
ikummarlussi	IV ;
ikummarluttuaannar	IV ;
ikummasersor	TV ;
ikummaser	XTiXmorf ;
ikummataa	IV ;
ikummaap	IV ;
ikumaavar	IV ;
ikungaannar	IV ;
ikunnar	IV ;
ikunnaa	IV ;
ikunnaap	TV ;
ikup	IV ;
ikup	TV ;
ikuser	XTiXmorf ;
ikusimiar	IV ;
ikusimiartor	IV ;
ikusimiar	TV ;
ikusimmiar	TV ;
ikusimmii	IV ;
ikusimmip	IV ;
ikusimmip	TV ;
ikusip	TV ;
ikussi	IV ;
ikussor	IV ;
ikussor	TV ;
ikussaa	IV ;
ikutsi	IV ;
ikuttaa	IV ;
ikuttaasior	IV ;
ikuttaatig	TVschwa ;
ikuu	IV ;
ikuunaqqup	IV ;
ikuunnap	IV ;
ikuusior	IV ;
ikaalior	IV ;
ikaaliortitsi	IV ;
ikaannar	IV ;
ikaap	IV ;
ikaap	TV ;
ikaarar	XIPXmorf ;
ikaar	IV ;
ikaarniartip	IV ;
ikaarrap	XIPXmorf ;
ikaarsimaar	IV ;
ikaarsior	IV ;
ikaarsaar	IV ;
ikaartarfior	IV ;
ikaartarfissualior	IV ;
ikaartip	IV ;
ikaartip	TV ;
ikaartiteri	IV ;
ikaartiterisar	IV ;
ikaartiter	TV ;
ikaartitigar	TVschwa ;
ikaartitig	TVschwa ;
ikaartitsi	IV ;
ikaartitaar	IV ;
ikaar	TV ;
ikaartaar	IV ;
ikaartaasior	IV ;
ikaartaasiortitsi	IV ;
ikaarup	TV ;
ikaaruser	TV ;
ikaarutig	TVschwa ;
ikaarutsiup	XIuteXmorf ;
ikaarutsiup	XTuteXmorf ;
ikaarutsiussi	IV ;
ikaasior	IV ;
ikaassarsi	IV ;
ikaassi	IV ;
ikaassor	XTPXmorf ;
ikaassui	IV ;
ikaassuisar	IV ;
ikaataa	IV ;
ilagiip	XIPXmorf ;
ilagiissutig	TVschwa ;
ilagiissutaa	IV ;
ilaginnar	TV ;
ilaginnaa	IV ;
ilaginnaajui	IV ;
ilaginnaajuip	XItsXmorf ;
ilagisariip	XIPXmorf ;
ilagisar	TVschwa ;
ilagisartaar	IV ;
ilagisartaar	TVschwa ;
ilagisaarup	IV ;
ilagiuminar	IV ;
ilag	TVschwa ;
ilagulluinnar	IV ;
ilagup	XIuteXmorf ;
ilagutivip	XIiXmorf ;
ilaguup	XIuteXmorf ;
ilaguussaar	IV ;
ilaguussaar	TV ;
ilaguutia	IV ;
ilaguutiinnaler	XIiXmorf ;
ilaguutiinnar	IV ;
ila	IV ;
ilajortor	XIPXmorf ;
ilajortor	XTPXmorf ;
ilakkuminar	IV ;
ilakkuminaap	XItsXmorf ;
ilakuerser	IV ;
ilakunnap	IV ;
ilakuuer	IV ;
ilaleri	IV ;
ilalernar	IV ;
ilalernartip	TV ;
ilaler	TV ;
ilaler	XTiXmorf ;
ilaliinnar	TV ;
ilalisariar	IV ;
ilalisar	IV ;
ilalisarluinnar	IV ;
ilalisaatig	TVschwa ;
ilaliulluinnar	IV ;
ilaliup	IV ;
ilaliup	TV ;
ilallattaari	IV ;
ilalaar	IV ;
ilalaartuaannar	IV ;
ilamaar	TV ;
ilanger	TV ;
ilangii	IV ;
ilangiisaraluar	IV ;
ilangiisar	IV ;
ilangiisip	TV ;
ilangiiuip	XItsXmorf ;
ilangiiuitsuu	IV ;
ilannar	TVschwa ;
ilanngarsi	IV ;
ilanngarsi	TV ;
ilanngarsivig	TVschwa ;
ilanngarter	XTPXmorf ;
ilanngartuup	XTuteXmorf ;
ilanngartuussi	IV ;
ilanngar	TV ;
ilannguffigiinnar	TV ;
ilannguffiginnip	IV ;
ilannguffig	TVschwa ;
ilanngup	XIuteXmorf ;
ilanngup	XTuteXmorf ;
ilanngussi	IV ;
ilanngussaa	IV ;
ilanngutassiar	TVschwa ;
ilanngutassii	IV ;
ilanngutassior	IV ;
ilanngutassiortunngorniar	IV ;
ilanngutassiortuu	IV ;
ilannguteriataar	IV ;
ilannguteriataar	TV ;
ilanngaa	IV ;
ilanngaalaar	IV ;
ilanngaaqqusiup	TV ;
ilanngaaqqutaa	IV ;
ilanngaaserisuu	IV ;
ilanngaaser	XTiXmorf ;
ilanngaasii	IV ;
ilanngaatig	TVschwa ;
ilanngaa	TV ;
ilanngaataa	IV ;
ilanngaavig	TVschwa ;
ilanniiar	TV ;
ilannaar	TVschwa ;
ilapittor	TV ;
ilapittuutig	TVschwa ;
ilapittuutaa	IV ;
ilap	IV ;
ilap	TV ;
ilaqajuip	XItsXmorf ;
ilaqajuitsussi	IV ;
ilaqajuitsuu	IV ;
ilaqartaannar	IV ;
ilaqutalisar	IV ;
ilaqutariikkuutaar	IV ;
ilaqutariip	XIPXmorf ;
ilaqutari	TV ;
ilaqutar	TVschwa ;
ilaqutsisar	IV ;
ilaqutaa	IV ;
ilarfallattaagaa	IV ;
ilarfallattaari	IV ;
ilarfallattaar	IV ;
ilarfallattaar	TV ;
ilar	IV ;
ilarnaveeqqusser	TV ;
ilarnaveeqqusser	XTiXmorf ;
ilarpaaneer	XTiXmorf ;
ilarrallattaagaa	IV ;
ilarrallattaari	IV ;
ilarrallattaar	IV ;
ilarrallattaar	TV ;
ilar	TV ;
ilar	XTiXmorf ;
ilasar	TV ;
ilaserinnip	IV ;
ilaser	IV ;
ilasertuaannar	IV ;
ilaser	TVschwa ;
ilaser	XTiXmorf ;
ilasiar	TVschwa ;
ilasiassarsior	IV ;
ilasi	IV ;
ilasiaa	IV ;
ilassarsiar	TVschwa ;
ilassarsi	IV ;
ilassarsior	IV ;
ilassarsiortor	IV ;
ilassarsior	TV ;
ilassarsi	TV ;
ilasseraar	IV ;
ilassiartor	TV ;
ilassi	IV ;
ilassilluar	IV ;
ilassilluar	TV ;
ilassinneqqussutaa	IV ;
ilassinngivip	XIiXmorf ;
ilassinnip	IV ;
ilassinnittussaa	IV ;
ilassior	IV ;
ilassior	TV ;
ilassissaar	IV ;
ilassissaar	TV ;
ilassi	TV ;
ilassug	TVschwa ;
ilassunnaap	XItsXmorf ;
ilassutig	TVschwa ;
ilassuup	XIuteXmorf ;
ilassuutikujup	IV ;
ilassuutiuip	XItsXmorf ;
ilassuutivissor	IV ;
ilassuuttunngorsar	IV ;
ilassuuttunngorsar	TV ;
ilassaarup	XIuteXmorf ;
ilassaaruteruttor	TV ;
ilasaari	IV ;
ilasaarillaqqip	XIiXmorf ;
ilasaarillaqqissuu	IV ;
ilasaar	TV ;
ilatser	IV ;
ilatser	XTiXmorf ;
ilatsiinnar	IV ;
ilatsip	TV ;
ilatsaasor	IV ;
ilatsaasornar	IV ;
ilatsaasor	TV ;
ilatsaasui	IV ;
ilattoor	IV ;
ilattoortip	TV ;
ilattor	IV ;
ilatuar	TVschwa ;
ila	TV ;
ilataar	IV ;
ilataar	TVschwa ;
ileqila	IV ;
ileqimisattor	IV ;
ileqimisattuinnar	IV ;
ileqimisaar	IV ;
ileqimisaartor	IV ;
ileqimisaartuinnar	IV ;
ileqqiser	TV ;
ileqqoriinnar	TV ;
ileqqorip	XIiXmorf ;
ileqqorissar	IV ;
ileqqorissar	TV ;
ileqqorissi	IV ;
ileqqorissuu	IV ;
ileqqorissaar	IV ;
ileqqorissaartuu	IV ;
ileqqori	TV ;
ileqqorler	XIiXmorf ;
ileqqorlup	IV ;
ileqqorluppallaar	IV ;
ileqqorluttuu	IV ;
ileqqorsior	TV ;
ileqqorsorajup	IV ;
ileqqorsor	IV ;
ileqqorsuusior	IV ;
ileqqorsuutig	TVschwa ;
ileqqor	TVschwa ;
ileqqulersuutig	TVschwa ;
ileqquliup	TV ;
ileqquliussi	IV ;
ileqquliutiinnar	TV ;
ileqqumisoor	IV ;
ileqqussaa	IV ;
ileqquu	IV ;
ileqqaallaqqip	XIiXmorf ;
ileqqaallaqqissi	IV ;
ileqqaallaqqissivip	XIiXmorf ;
ileqqaap	TV ;
ileqqaar	IV ;
ileqqaarniar	IV ;
ileqqaar	TV ;
ileqqaarup	TV ;
ilerag	TVschwa ;
ileranannginneru	IV ;
ilerananngivip	XIiXmorf ;
ileranaq	K ;
ileranar	IV ;
ileranaap	XItsXmorf ;
ilerasujuip	XItsXmorf ;
ilerasup	IV ;
ilerasuutig	TVschwa ;
ileratsap	IV ;
ileratsavip	XIiXmorf ;
ileratsaap	TV ;
ileratsaatig	TVschwa ;
ilerattaap	IV ;
ilerattaap	XItsXmorf ;
ilerfiar	IV ;
ilerfiarpassuu	XIPXmorf ;
ilerfior	IV ;
ilerfior	TV ;
ilerfu	IV ;
ilernikor	TVschwa ;
ilernikulior	IV ;
ilernikulior	TV ;
ilerriar	IV ;
ilerruffig	TVschwa ;
ilerru	IV ;
ilersi	IV ;
ilersi	TV ;
ileraap	XItsXmorf ;
iliarsoqqiu	IV ;
iliarsoror	IV ;
iligiikkuutaar	IV ;
iligiip	XIPXmorf ;
iligiler	XTiXmorf ;
iligilluar	TV ;
ilig	TVschwa ;
iliillisaa	IV ;
iliilli	TV ;
iliip	IV ;
iliip	XItsXmorf ;
ili	IV ;
ilikkaja	IV ;
ilikkajortor	TV ;
ilikkapallap	IV ;
ilikkapallap	TV ;
ilikkar	IV ;
ilikkarseriar	IV ;
ilikkarseriip	XItsXmorf ;
ilikkartip	TV ;
ilikkartivip	TV ;
ilikkartivip	XTiXmorf ;
ilikkar	TV ;
ilikkaruminar	IV ;
ilikkaruminaap	XItsXmorf ;
ilikkaruminaatsip	TV ;
ilikkarunnarsigaluar	IV ;
ilikkarunnarsigaluar	TV ;
ilikkarunnarsi	IV ;
ilikkarunnarsi	TV ;
ilikkarussi	IV ;
ilikkavip	XIiXmorf ;
ilikkuminanaar	TV ;
ilikkuminar	IV ;
ilikkaap	TV ;
ilikkaap	XTuteXmorf ;
ilikkaassiinnar	IV ;
ilikkaassi	IV ;
ilikkaatiinnar	TV ;
ilimagigaluar	TV ;
ilimagineqaraluar	IV ;
ilimagineqarsinnaa	IV ;
ilimaginninnip	IV ;
ilimag	TVschwa ;
ilimakkeer	TV ;
Ilimanamukar	IV ;
ilimanaraluar	IV ;
ilimanar	IV ;
ilimanarsi	IV ;
ilimanarsinnaa	IV ;
ilimanarsip	IV ;
ilimasuarnar	IV ;
ilimasuer	IV ;
ilimasupilup	IV ;
ilimasup	IV ;
ilimasuutig	TVschwa ;
ilimasuutaa	IV ;
ilimasaari	IV ;
ilimasaar	TV ;
ilimasaarutig	TVschwa ;
ilimasaarutaa	IV ;
ilimatsap	IV ;
ilimatsaap	XIuteXmorf ;
ilimatsaatig	TVschwa ;
ilimatsaativip	XTiXmorf ;
ilimatsaa	TV ;
ilimmar	IV ;
ilinga	IV ;
ilingisup	IV ;
ilinngap	IV ;
ilinngar	IV ;
ilinngassar	IV ;
ilinngassar	TV ;
ilinniagakinneru	IV ;
ilinniagassaa	IV ;
ilinniaqqaagassaa	IV ;
ilinniareer	IV ;
ilinniarfig	TVschwa ;
ilinniarnertuuju	IV ;
ilinniarnertuunngorniar	IV ;
ilinniarsimanngikkaluar	IV ;
ilinniarsimanngikkaluar	TV ;
ilinniartip	TV ;
ilinniartitsi	IV ;
ilinniartitsisunngor	IV ;
ilinniartitsisunngorniar	IV ;
ilinniartitsisuu	IV ;
ilinniartitsisuuneru	IV ;
ilinniikkusup	IV ;
ilinnikuu	IV ;
ilinniusior	IV ;
ilioqqar	TV ;
ilioqqaa	IV ;
ilioraluar	IV ;
iliorar	TV ;
iliorfig	TVschwa ;
ilioriusissaarup	IV ;
ilioriusissaarutivip	XIiXmorf ;
ilior	IV ;
iliorner	XTiXmorf ;
iliortarner	XTiXmorf ;
ilior	TV ;
ilioruup	IV ;
ilioraa	IV ;
ilip	IV ;
ilippaginnip	IV ;
ilippag	TVschwa ;
ilippanar	IV ;
ilippanartig	TVschwa ;
ilip	TV ;
ilip	XItX ;
ilisarinnip	IV ;
ilisarisimannilluar	IV ;
ilisarisimannilluartuu	IV ;
ilisarisimannip	IV ;
ilisarisaa	IV ;
ilisaritip	IV ;
ilisarititsi	IV ;
ilisaritittoor	IV ;
ilisariuminar	IV ;
ilisariuminarsar	IV ;
ilisariuminarsi	IV ;
ilisariuminartuu	IV ;
ilisariuminaap	XItsXmorf ;
ilisariuminaassi	IV ;
ilisarivip	XTiXmorf ;
ilisarnaqutig	TVschwa ;
ilisarnar	IV ;
ilisarnartig	TVschwa ;
ilisarnaasersor	TV ;
ilisarnaaser	TV ;
ilisarnaatig	TVschwa ;
ilisarsi	IV ;
ilisarsiniutig	TVschwa ;
ilisarsaa	IV ;
ilisarsaanngivip	XIiXmorf ;
ilisar	TVschwa ;
iliseeri	IV ;
ilisiiffig	TVschwa ;
ilisiinniusior	IV ;
ilisiip	TV ;
ilisiip	XItsXmorf ;
ilisiitsuu	IV ;
ilisi	IV ;
ilisimajunnaartip	TV ;
ilisimajunnaartitsi	IV ;
ilisimajunnaar	XIiXmorf ;
ilisimaneqarluar	IV ;
ilisimanersaa	IV ;
ilisimaniar	IV ;
ilisimaniarpallaar	IV ;
ilisimanngivip	TV ;
ilisimannilluar	IV ;
ilisimannip	IV ;
ilisimannittuu	IV ;
ilisimaqqissaar	IV ;
ilisimaqqissaar	TV ;
ilisimarnguser	IV ;
ilisimasakitsorsuu	IV ;
ilisimasalissuu	IV ;
ilisimasaqanngivip	XIiXmorf ;
ilisimasaqarner	IV ;
ilisimasaqarneru	IV ;
ilisimasassarsior	IV ;
ilisimasortassarsior	IV ;
ilisimasortaa	IV ;
ilisimassutig	TVschwa ;
ilisimatip	TV ;
ilisimatitsi	IV ;
ilisimatungaar	IV ;
ilisimatusar	IV ;
ilisimatusaatig	TVschwa ;
ilisimatuuju	IV ;
ilisimatuunngor	IV ;
ilisimatuunngorniutig	TVschwa ;
ilisimatuunngortip	TV ;
ilisimavallaar	IV ;
ilisimavallaar	TV ;
ilisimavip	XTiXmorf ;
ilisimmarip	XIiXmorf ;
ilisimmar	IV ;
ilisimmartip	TV ;
ilisimmaap	TV ;
ilisimmaarip	XIiXmorf ;
ilisimmaarissi	IV ;
ilisimaap	XItsXmorf ;
ilisimaarilluinnar	TV ;
ilisimaarinnip	IV ;
ilisimaar	TVschwa ;
ilisimaatsorpallap	IV ;
ilisimaatsorpalunneru	IV ;
ilisimaatsorpalaar	IV ;
ilisimaatsulluinnar	IV ;
ilisip	TV ;
ilisisar	IV ;
ilisisoqartip	TV ;
ilisissup	TV ;
ilisiveerup	IV ;
ilisiveerup	XIuteXmorf ;
ilisiveerup	XTuteXmorf ;
ilisiveerussi	TV ;
ilisiveerutivip	XIiXmorf ;
ilisivilersor	TV ;
ilisivilersui	IV ;
ilisivittaar	IV ;
ilisiviu	IV ;
ilissamaaser	IV ;
ilissamaasersor	IV ;
ilissamaatig	TVschwa ;
ilissamaataa	IV ;
ilissarsi	IV ;
ilissarsior	IV ;
ilisseri	IV ;
ilisserillaqqip	XIiXmorf ;
ilisser	IV ;
ilissernerlup	TV ;
ilisser	TV ;
ilisserusior	IV ;
ilisserusior	TV ;
ilisserutig	TVschwa ;
ilisserutser	XTiXmorf ;
ilisserutaa	IV ;
ilisser	XTiXmorf ;
ilissigaa	IV ;
ilissunnip	XItsXmorf ;
ilissaa	IV ;
ilisaagallar	IV ;
ilisaa	IV ;
ilitsersortig	TVschwa ;
ilitsersor	TV ;
ilitsersui	IV ;
ilitsersuup	TV ;
ilitsersuusior	IV ;
ilitsersuussiartor	IV ;
ilitsersuussi	IV ;
ilitsersuussinerlup	IV ;
ilitsersuussiniar	IV ;
ilitsersuussutig	TVschwa ;
ilitsersuutig	TVschwa ;
ilitser	XTiXmorf ;
ilitsii	IV ;
ilitsiisar	IV ;
ilitsiisuu	IV ;
ilitsi	IV ;
ilitsilertornar	IV ;
ilitsillaqqip	IV ;
ilitsillaqqip	XIiXmorf ;
ilitsip	TV ;
ilitsiveerup	IV ;
ilitsiveerup	TV ;
ilitsiveerusi	IV ;
ilitsiveerusi	TV ;
ilitsiveerussi	IV ;
ilitsiveerussi	TV ;
ilitsoqqup	TV ;
ilitsoqqussar	TVschwa ;
ilitsoqqussi	IV ;
ilitsoqqutig	TVschwa ;
ilitsori	IV ;
ilitsoriler	XIiXmorf ;
ilitsorilluar	IV ;
ilitsorisimassuseerup	IV ;
ilitsor	IVschwa ;
ili	TV ;
iliugajup	IV ;
iliu	IV ;
iliulluar	IV ;
iliuup	IV ;
iliveqarfileri	IV ;
iliveqarfilerisuu	IV ;
iliver	XTiXmorf ;
ilivilior	IV ;
ilivip	XIiXmorf ;
ilivitsuu	IV ;
ilivitsuusiar	TVschwa ;
illakulup	IV ;
illakuluutiginnip	IV ;
illakuluutig	TVschwa ;
illalaar	IV ;
illarajup	IV ;
illarasaaginnar	IV ;
illarasaar	IV ;
illarfig	TVschwa ;
illar	IV ;
illarnar	IV ;
illarpalup	IV ;
illarrap	XIPXmorf ;
illarsar	IV ;
illarsaari	IV ;
illarsaarisar	IV ;
illarsaarissutig	TVschwa ;
illaruar	IV ;
illarujussuar	IV ;
illarujussuaannar	IV ;
illaruaatiginnip	IV ;
illaruaatig	TVschwa ;
illaruaatissanngortiinnar	IV ;
illaruaatissanngortip	IV ;
illaruaatissanngortip	TV ;
illassaqanngivip	XIiXmorf ;
illasuutig	TVschwa ;
illeqanngitsuu	IV ;
illerar	IV ;
illerar	TV ;
illernar	IV ;
illernarsar	TV ;
illernarsi	IV ;
illernartitaa	IV ;
illersartor	XIPXmorf ;
illersip	TV ;
illersor	IV ;
illersorneqarsinnaa	IV ;
illersortig	TVschwa ;
illersor	TV ;
illersui	IV ;
illersuisuu	IV ;
illersuutig	TVschwa ;
iller	TVschwa ;
illertaar	IV ;
illerusaar	IV ;
illerusaarrap	XIPXmorf ;
illeruup	TV ;
iller	XIiXmorf ;
iller	XTiXmorf ;
illialup	IV ;
illigisaqanngivip	XIiXmorf ;
illigisartusi	IV ;
illig	TVschwa ;
illigup	IV ;
illigussaar	TV ;
illigutsap	IV ;
illigutsip	TV ;
illigutsaap	TV ;
illigutsaassi	IV ;
illii	IV ;
illiisuu	IV ;
illiiuma	IV ;
illikar	IV ;
illikarsinnaa	IV ;
illikartilaar	TV ;
illikartip	TV ;
illikartoor	IV ;
illikartoortip	TV ;
illikar	TV ;
illikaa	IV ;
illikaajuar	IV ;
illikaatip	TV ;
illikaattoor	IV ;
illikaattoortip	TV ;
illinilior	IV ;
illinilior	TV ;
illinnanngivip	XIiXmorf ;
illinnaq	K ;
illinnar	IV ;
illinnaap	XItsXmorf ;
illip	IV ;
illipoor	IV ;
illipoor	TV ;
illip	TV ;
illisersor	TV ;
illisilersor	TV ;
illisilersuup	IV ;
illisilersuup	TV ;
illisiler	XTiXmorf ;
illissersor	TV ;
illisser	XTiXmorf ;
illissi	IV ;
illissaa	IV ;
illissaar	TV ;
illisaajar	IV ;
illisaajar	TV ;
illitsersor	TV ;
illitsersuup	IV ;
illitsersuup	TV ;
illitser	TV ;
illitser	XTiXmorf ;
illiu	IV ;
illiukkuma	IV ;
illiup	IV ;
illiup	TV ;
illiusuu	IV ;
illoor	IV ;
illoqaler	XIiXmorf ;
illoqarfimmiuu	IV ;
illoqarfimmukar	IV ;
illoqarfissuu	IV ;
illoqasiup	TV ;
illoqatigiip	XIPXmorf ;
illoqatig	TVschwa ;
illoqqup	TV ;
illoriip	XIPXmorf ;
illorsuarnukar	IV ;
illor	TVschwa ;
illuar	IV ;
illuartip	TV ;
illuartoor	IV ;
illuar	TV ;
illuartaariup	IV ;
illuatigoor	IV ;
illueriartor	IV ;
illuer	IV ;
illuerup	IV ;
illugiikkuutar	XIPXmorf ;
illugiip	IV ;
illugiip	XIPXmorf ;
illugiissitaar	TV ;
illugiissaar	TV ;
illugiiaar	XIPXmorf ;
illugip	XIiXmorf ;
illugissi	IV ;
illugissaari	IV ;
illugissaar	IV ;
illug	TVschwa ;
illuigartaar	IV ;
illuigaa	IV ;
illuikki	IV ;
illuikkior	IV ;
illuinnarsior	IV ;
illuinnarsor	IV ;
illuinnarsuuteqartitaa	IV ;
illuinnaasior	IV ;
illukinaar	TV ;
illukisaar	IV ;
illukisaar	TV ;
illukorsior	IV ;
illukusior	IV ;
illuler	TV ;
illuliorfigissaa	IV ;
illuliorfig	TVschwa ;
illuliorfiu	IV ;
illulior	IV ;
illuliortitsi	IV ;
illuliortitsisuu	IV ;
illulior	TV ;
illunga	IV ;
illungavallaar	IV ;
illunikkiartor	IV ;
illunip	IV ;
illunnar	IV ;
illunnguusaa	IV ;
illunnaar	TVschwa ;
illunukar	IV ;
illunukaa	IV ;
illuperar	IV ;
illuperar	TV ;
illuperaar	IV ;
illuperaar	TV ;
illupiar	IV ;
illup	IV ;
illup	TV ;
illusariar	IV ;
illusariar	TV ;
illusar	TV ;
illusi	IV ;
illusimmavig	TVschwa ;
illusiniar	IV ;
illusinaar	IV ;
illusinaar	TV ;
illusip	IV ;
illusippallaar	IV ;
illusisinnar	IV ;
illusisip	TV ;
illusisitsi	IV ;
illusaa	IV ;
illusaasior	IV ;
illuttor	IV ;
illuttoruup	TV ;
illutaa	IV ;
illutaar	IV ;
illuusaarup	IV ;
illuutig	TVschwa ;
illuaami	IV ;
illuaamisip	TV ;
illuaami	TV ;
illaagutaarser	XIiXmorf ;
illaa	IV ;
illaaller	XIiXmorf ;
illaari	IV ;
illaar	IV ;
illaarsigallar	IV ;
illaarsigallaat	K ;
illaarsi	IV ;
illaarsaar	IV ;
illaar	TV ;
illaatigiinnar	TV ;
illaatiginnip	IV ;
illaatigisassaannaa	IV ;
illaatig	TVschwa ;
illaattor	IV ;
iloqianngor	IV ;
iloqisser	IV ;
iloqissior	IV ;
iloqiaa	IV ;
iloqqa	IV ;
iloqqa	TV ;
iloqqup	TV ;
iloqqutsi	IV ;
iloqqutsor	IV ;
iloqqutsug	TVschwa ;
iloqutser	TV ;
ilorfarmip	TV ;
ilorfarmoor	TV ;
ilorfaallag	TVschwa ;
ilorfaallap	IV ;
ilorfaallatsip	TV ;
ilorler	XTiXmorf ;
ilorlii	IV ;
ilorli	TV ;
ilorliu	IV ;
ilorpar	IV ;
ilorparter	IV ;
ilorpasip	IV ;
ilorpasip	XIiXmorf ;
ilorrarmip	TV ;
ilorrarmoor	IV ;
ilorrarmoor	TV ;
ilorri	IV ;
ilorrior	IV ;
ilorrior	TV ;
ilorrip	IV ;
ilorrip	XIiXmorf ;
ilorrisimaar	IV ;
ilorrisimaarnar	IV ;
ilorrisaar	IV ;
ilorrisaarnar	IV ;
ilorru	IV ;
ilorraallag	TVschwa ;
ilorraallak	K ;
ilorraallannar	IV ;
ilorraallap	IV ;
ilorraallatsip	TV ;
iltilersor	TV ;
iluakkoor	IV ;
iluameer	IV ;
iluameersitsiniar	IV ;
iluangerajup	IV ;
iluanger	IV ;
iluangertaannar	IV ;
iluaniittoqarpalup	IV ;
iluanaaqutig	TVschwa ;
iluanaarajup	IV ;
iluanaar	IV ;
iluanaarluar	IV ;
iluanaarniapilup	IV ;
iluanaarniuteqarpallaar	IV ;
iluanaarpallaar	IV ;
iluanaartitsi	IV ;
iluanaar	TV ;
iluanaarup	TV ;
iluanaarutig	TVschwa ;
iluaqusersor	TV ;
iluaqusersuiniar	IV ;
iluaqusersuutig	TVschwa ;
iluaquser	XTiXmorf ;
iluaqusiinnar	TV ;
iluaqusiup	TV ;
iluaqutigineqarsinnaagaluar	IV ;
iluaqutigineqarsinnaa	IV ;
iluaqutig	TVschwa ;
iluaqutissiui	IV ;
iluaqutsii	IV ;
iluaqutsiup	TV ;
iluaqutsiussi	IV ;
iluaqutaa	IV ;
iluaqutaasussaagaluar	IV ;
iluaqutaasussaa	IV ;
iluariinnar	TV ;
iluarinar	IV ;
iluarinartip	TV ;
iluarinngivip	XTiXmorf ;
iluarinnip	IV ;
iluarisariip	XIPXmorf ;
iluarisaa	IV ;
iluari	TV ;
iluar	IV ;
iluarnerar	TV ;
iluarnersior	IV ;
iluarnersiorniarumaar	IV ;
iluarnersior	TV ;
iluarneru	IV ;
iluarnerutip	TV ;
iluarniar	IV ;
iluarsartuup	TV ;
iluarsartuussi	IV ;
iluarsar	TV ;
iluarsiartor	IV ;
iluarsiartor	TV ;
iluarsiissutig	TVschwa ;
iluarsi	IV ;
iluarsissutig	TVschwa ;
iluarsi	TV ;
iluarsivip	TV ;
iluarsivip	XIiXmorf ;
iluarsaa	IV ;
iluarsaap	TV ;
iluarsaaqqip	XIiXmorf ;
iluarsaassereer	IV ;
iluarsaassi	IV ;
iluarsaateqqu	IV ;
iluarsaatig	TVschwa ;
iluartinnaviar	TV ;
iluartip	TV ;
iluartitsi	IV ;
iluartitaari	IV ;
iluartulior	IV ;
iluartunnguutig	TVschwa ;
iluartuu	IV ;
iluartuussutig	TVschwa ;
iluartuusaar	IV ;
iluartuutip	TV ;
iluartuutitsi	IV ;
iluartuutitaa	IV ;
iluar	TVschwa ;
iluasaaqqinnaar	IV ;
iluasaaqqissaar	IV ;
iluasaaqqissaar	TV ;
iluasaar	IV ;
iluasaar	TV ;
iluasaartaannar	IV ;
iluatigoor	IV ;
iluatig	TVschwa ;
iluatikkunnar	IV ;
iluatikkup	TV ;
iluatikkussi	IV ;
iluatinnar	IV ;
iluatinnavip	XIiXmorf ;
iluatissar	IV ;
iluatissaa	IV ;
iluatseqqinnaar	TV ;
iluatsikkiartor	IV ;
iluatsikkiartor	TV ;
iluatsinngitsoor	IV ;
iluatsinngitsoor	TV ;
iluatsip	TV ;
iluatsitsi	IV ;
iluatsitsilluar	IV ;
iluatsitsinerinnaa	IV ;
iluatsitsivip	IV ;
iluatsitaari	IV ;
ilueqarfiu	IV ;
iluer	XTiXmorf ;
iluilluinnar	IV ;
iluip	IV ;
iluip	XItsXmorf ;
iluitsuu	IV ;
ilu	IV ;
ilukip	XItsXmorf ;
ilulequtser	TV ;
ilulequtaa	IV ;
iluleriip	XIPXmorf ;
iluleriissitaar	XIPXmorf ;
iluleriissaar	XIPXmorf ;
iluleriissaar	XTPXmorf ;
ilulianip	IV ;
iluliarmiuu	IV ;
iluliiaataarup	IV ;
iluliler	XTiXmorf ;
ilulissanukar	IV ;
ilulisser	IV ;
ilulissersorsuu	IV ;
ilulisser	XTiXmorf ;
ilulissiar	IV ;
iluliuma	IV ;
iluliummarip	IV ;
iluliummarip	XIiXmorf ;
iluliummar	IV ;
iluliummartip	TV ;
iluliummaap	IV ;
iluliusanip	IV ;
ilullersaar	IV ;
iluller	XIiXmorf ;
iluller	XTiXmorf ;
ilulli	IV ;
ilullilersor	IV ;
ilulliler	XIiXmorf ;
ilulliler	XTiXmorf ;
ilullisaa	IV ;
ilulli	TV ;
ilulliup	TV ;
ilulliussaa	IV ;
ilulutsip	IV ;
iluluumer	IV ;
iluluumi	IV ;
iluluummer	IV ;
ilumikker	IV ;
ilumikkisser	IV ;
ilumikkiup	TV ;
ilumikkiussi	IV ;
ilumiler	XIiXmorf ;
ilumip	IV ;
ilumiug	TVschwa ;
ilumiuler	XTiXmorf ;
ilumiuliup	TV ;
ilumiuu	IV ;
ilummiar	IV ;
ilummoor	IV ;
ilummukar	IV ;
ilummukaap	TV ;
ilummukaassi	IV ;
ilummuulaaginnar	IV ;
ilumooqqinnaar	IV ;
ilumoorfig	TVschwa ;
ilumoor	IV ;
ilumoorsaar	IV ;
ilumoorsaavip	XIiXmorf ;
ilumoortuaannar	IV ;
ilumoortaannar	IV ;
ilumoorup	TV ;
ilumoorussi	IV ;
ilumoorussivip	XIiXmorf ;
ilumoorutivip	TV ;
ilumuuip	XIiXmorf ;
ilunar	IV ;
ilunger	IV ;
ilungersor	IV ;
ilungersornar	IV ;
ilungersorpalup	IV ;
ilungersortuar	IV ;
ilungersua	IV ;
ilungersuanar	IV ;
ilungersuassutig	TVschwa ;
ilungersunar	IV ;
ilungersungaar	IV ;
ilungersuup	TV ;
ilungersuussi	IV ;
ilungersuuterujussuanngikkaluar	TV ;
ilungersuuterujussuar	TV ;
ilungersuutiginnip	IV ;
ilungersuutig	TVschwa ;
ilunger	XTiXmorf ;
ilunngu	IV ;
ilunngunar	IV ;
ilunngussutig	TVschwa ;
ilunnguummi	IV ;
ilunnguumminar	IV ;
ilunnguummissutig	TVschwa ;
ilunnguutig	TVschwa ;
ilupaqusersor	TV ;
ilupaquser	XTiXmorf ;
ilupaqutser	IV ;
ilupaqutsersor	TV ;
ilupaqutser	TV ;
ilupasser	IV ;
ilupasser	XTiXmorf ;
ilupaar	IV ;
ilupaar	TV ;
ilupaartaar	IV ;
ilupaaruser	IV ;
ilupaaruser	TV ;
ilupaarutser	IV ;
ilupaarutser	TV ;
ilupaarutser	XTiXmorf ;
ilupaaver	IV ;
ilupaaver	XTiXmorf ;
iluseer	IV ;
iluserip	IV ;
iluserip	XIiXmorf ;
iluserissi	IV ;
iluserlior	IV ;
iluserlup	IV ;
ilusilersui	IV ;
ilusilersuutig	TVschwa ;
ilusilup	IV ;
ilutammip	IV ;
ilutammip	TV ;
ilutigiip	XIPXmorf ;
ilutigiiaar	XIPXmorf ;
ilutig	TVschwa ;
ilutsersor	TV ;
ilutser	TV ;
ilutser	XTiXmorf ;
iluttor	TV ;
iluttorup	IV ;
iluttuarpalup	IV ;
ilutuallaar	IV ;
ilutu	IV ;
ilutunersaa	IV ;
ilutaarup	IV ;
iluunngar	IV ;
iluunngar	TV ;
iluaaginnip	IV ;
iluaag	TVschwa ;
iluaakkunnaar	XIiXmorf ;
iluaakujup	IV ;
iluaallag	TVschwa ;
iluaallak	K ;
iluaallannar	IV ;
iluaallap	IV ;
iluaallatsip	TV ;
iluaallersar	IV ;
iluaaller	XIiXmorf ;
iluaalli	IV ;
iluaallior	IV ;
iluaallaatig	TVschwa ;
iluaanneru	IV ;
iluaap	IV ;
iluaap	XItsXmorf ;
iluaatsulior	IV ;
ilaaginnar	IV ;
ilaa	IV ;
ilaajar	TV ;
ilaajumagaluar	IV ;
ilaajuma	IV ;
ilaajumaar	IV ;
ilaajaa	IV ;
ilaajaatitaa	IV ;
ilaajaataa	IV ;
ilaanar	IV ;
ilaanarumaar	IV ;
ilaannagiip	XIPXmorf ;
ilaannakuu	IV ;
ilaannarsior	IV ;
ilaanna	TV ;
ilaannaa	IV ;
ilaaqarpallaar	IV ;
ilaaqqukkajup	IV ;
ilaaqqup	XIuteXmorf ;
ilaaqqutillariar	IV ;
ilaaqqutillariaa	IV ;
ilaaqqutillattaar	IV ;
ilaaqqutipajup	IV ;
ilaari	IV ;
ilaarsigajup	IV ;
ilaarsiinnar	IV ;
ilaarsiinnavip	XIiXmorf ;
ilaarsi	IV ;
ilaartor	IV ;
ilaartor	TV ;
ilaartui	IV ;
ilaartuutissarsi	IV ;
ilaar	TV ;
ilaartaa	IV ;
ilaarunnar	IV ;
ilaarunnarpallaar	IV ;
ilaarup	IV ;
ilaarutig	TVschwa ;
ilaarutillii	IV ;
ilaasortanngor	IV ;
ilaasortaa	IV ;
ilaassamaatig	TVschwa ;
ilaassutissaleri	IV ;
ilaassutissarsi	IV ;
ilaassutissaarniar	IV ;
ilaasuinnaa	IV ;
ilaasussaarup	IV ;
ilaatigooriar	IV ;
ilaavarsup	IV ;
imakilli	IV ;
imakillip	TV ;
imakillisoor	IV ;
imakilli	TV ;
imakinaar	TV ;
imakip	IV ;
imakippallaar	IV ;
imakip	XItsXmorf ;
imakunnger	IV ;
imakutor	IV ;
imalilior	IV ;
imaliliortarsinnaa	IV ;
imanger	IV ;
imangersar	TV ;
imangersaa	IV ;
imanngarip	XIiXmorf ;
imanngasip	XIiXmorf ;
imannaa	IV ;
imannaali	IV ;
imannaap	IV ;
imaqanngivip	XIiXmorf ;
imaqaraluar	IV ;
imaqarluar	IV ;
imaqarnersior	TV ;
imaqarnersiui	IV ;
imaqarneru	IV ;
imaqarnilior	IV ;
imaqarnilior	TV ;
imaqqik	K ;
imaqqortu	IV ;
imaqqortunersaa	IV ;
imaqqukip	XItsXmorf ;
imaqulatsi	IV ;
imarianip	IV ;
imarigajup	TV ;
imarip	XIiXmorf ;
imarissi	IV ;
imarissorsuugaluar	IV ;
imarissorsuu	IV ;
imarnersanip	IV ;
imarnersaarup	IV ;
imaror	IV ;
imarorsii	IV ;
imarorsii	TV ;
imarpissuakkoor	IV ;
imarsarner	IV ;
imarsioqqip	XIiXmorf ;
imarsior	IV ;
imarsiorpalup	IV ;
imarsiortunngor	IV ;
imarsiortunngorniar	IV ;
imarsiortuu	IV ;
imarsiullaqqip	XIiXmorf ;
imarsiutikkuminar	IV ;
imarsiutikkuminaap	XItsXmorf ;
imarsiutaa	IV ;
imarsunni	K ;
imarsunnip	IV ;
imartip	TV ;
imartu	IV ;
imartuneru	IV ;
imar	TV ;
imar	TVschwa ;
imaruala	IV ;
imaruarpalup	IV ;
imaruarpaluttuinnaa	IV ;
imarunngu	IV ;
imaruup	TV ;
imaruussaa	IV ;
imassaarup	IV ;
imassaataarup	IV ;
imaviartaa	IV ;
imeerukkallar	IV ;
imeerunnaveersaar	IV ;
imeerup	IV ;
imeerutissaar	IV ;
imeqarfig	TVschwa ;
imeqqutammip	TV ;
imeqqutaalarniar	IV ;
imerajuersar	IV ;
imerajuersar	TV ;
imerajup	IV ;
imerajuppallaar	IV ;
imerajussi	IV ;
imerajussivip	XIiXmorf ;
imerajuttunngor	IV ;
imerajuttuu	IV ;
imeratsip	IV ;
imeriilip	IV ;
imeriilitsip	TV ;
imerip	IV ;
imerip	XIiXmorf ;
imerissi	IV ;
imerissorsuu	IV ;
imer	IV ;
imerlaarsi	IV ;
imerneqarsinnaa	IV ;
imerngaala	IV ;
imerngaalatip	TV ;
imerngaallap	IV ;
imerngaalaar	IV ;
imerngaalaartuinnaa	IV ;
imernaala	IV ;
imernaalatip	TV ;
imernaallap	IV ;
imernaalaar	IV ;
imernaalaartuinnaa	IV ;
imeror	IV ;
imerpala	IV ;
imerpallap	IV ;
imerpallap	TV ;
imerpallassar	TV ;
imerpallassaaser	TV ;
imerpalaar	IV ;
imersi	IV ;
imersimaar	IV ;
imersior	IV ;
imersunnig	TVschwa ;
imersunnip	XItsXmorf ;
imertarajup	IV ;
imertarfinnaar	TVschwa ;
imertar	IV ;
imertartarfig	TVschwa ;
imerteriartor	IV ;
imerteri	IV ;
imerter	TV ;
imerter	XTiXmorf ;
imer	TV ;
imertaap	TV ;
imertaaser	IV ;
imertaatig	TVschwa ;
imeruersaatig	TVschwa ;
imerukkunnaar	IV ;
imerunnaveersaar	IV ;
imerup	IV ;
imerusuersar	IV ;
imerusuersar	TV ;
imerusukkunnaar	IV ;
imerusup	IV ;
imeruup	TV ;
imer	XTiXmorf ;
imeraaler	IV ;
imeraalaaler	IV ;
imeraalaar	IV ;
imeraartitsi	IV ;
imeraar	XIPXmorf ;
imia	IV ;
imiar	TVschwa ;
imigassarsi	IV ;
imigassaa	IV ;
imigassaajunnaar	IV ;
imigassaanngivip	XIiXmorf ;
imigaa	IV ;
imiilatsi	IV ;
imiilatsinar	IV ;
imiilatsisorsuu	IV ;
imiilatsiunnaar	XIPXmorf ;
imiinnalior	IV ;
imiinnaa	IV ;
imiip	IV ;
imiisap	IV ;
imiisivittaar	IV ;
imiisor	IV ;
imiisortaannar	IV ;
imikkallar	TV ;
imikkallaak	K ;
imillunga	IV ;
imillup	IV ;
imillutsip	TV ;
imilluttaasior	IV ;
iminnar	IV ;
iminnarunnaar	IV ;
iminnger	IV ;
iminngernaveersaartuu	IV ;
iminngerpallaar	IV ;
iminngersi	IV ;
iminngersivip	XIiXmorf ;
iminngersorsuu	IV ;
iminngersuu	IV ;
iminnaap	XItsXmorf ;
imip	IV ;
imip	TV ;
imissar	TV ;
imissiartor	IV ;
imissi	IV ;
imissutig	TVschwa ;
imissutaa	IV ;
imissaaleqiffiu	IV ;
imissaaleqi	IV ;
imissaaleqiunnaarsip	TV ;
imissaaleqiunnaar	XIiXmorf ;
imissaar	IV ;
imissaarup	IV ;
imitip	IV ;
imitip	TV ;
imitsiar	TV ;
imitsip	TV ;
imitsaalior	TV ;
imitsaaliui	IV ;
imiutaarup	IV ;
immakkiartor	IV ;
immap	IV ;
immaqaar	IV ;
immaqaarnar	IV ;
immaqaartor	IV ;
immatser	IV ;
immattoor	IV ;
immeqqaa	IV ;
immeqqaajunnaar	IV ;
immeqqaar	TV ;
immeqqaasar	IV ;
immerar	IV ;
immerarteqattaar	IV ;
immerartikkunnaar	IV ;
immerartip	IV ;
immerar	TV ;
immeri	IV ;
immerisaannar	IV ;
immersor	IV ;
immersor	TV ;
immertip	TV ;
immertussaa	IV ;
immertaar	IV ;
immer	XIiXmorf ;
immer	XTiXmorf ;
immeraaffig	TVschwa ;
immeraakkajup	IV ;
immeraap	IV ;
immeraatig	TVschwa ;
immeraataa	IV ;
immialler	XIiXmorf ;
immialaalior	IV ;
immiarsiar	TVschwa ;
immiarsi	IV ;
immiarsunni	K ;
immiarsunnip	XItsXmorf ;
immiar	TVschwa ;
immiassarsi	IV ;
immiassarsiniariar	IV ;
immigalior	IV ;
immigaliortaannar	IV ;
immigiar	IV ;
immigaa	IV ;
immigaalluar	IV ;
immii	IV ;
immiisissarsi	IV ;
immiisissaarup	IV ;
immikkallar	TV ;
immikkior	IV ;
immikkiortaannar	IV ;
immikkoor	IV ;
immikkoorniar	IV ;
immikkoortip	TV ;
immikkoortiteri	IV ;
immikkoortiterisar	IV ;
immikkoortiter	TV ;
immikkoortitsi	IV ;
immikkoortitsineru	IV ;
immikkoortitaa	IV ;
immikkoorutig	TVschwa ;
immikkuualup	IV ;
immikkuulup	IV ;
immikkuutaar	XIPXmorf ;
immilitseri	IV ;
immilitser	TV ;
immineer	IV ;
immineersip	TV ;
immineersor	IV ;
immineertaannar	IV ;
imminersor	IV ;
imminiiginnar	TV ;
imminoor	IV ;
immiorajup	IV ;
immior	IV ;
immiortitsi	IV ;
immip	IV ;
immip	TV ;
immisip	TV ;
immisitsiar	TV ;
immisoor	IV ;
immisoor	TV ;
immitseri	IV ;
immitser	TV ;
immitser	XTiXmorf ;
immitsiar	TV ;
immitsii	IV ;
immitsi	IV ;
immitsijui	IV ;
immitsijuip	XItsXmorf ;
immitsijuitsuu	IV ;
immitsisaannar	IV ;
immiup	TV ;
immiussiartor	IV ;
immiussiartortor	IV ;
immiussi	IV ;
immiussisar	IV ;
immiussaa	IV ;
immiaaraller	IV ;
immiaaraller	XIiXmorf ;
immiaarartor	IV ;
immiaarartuup	XIPXmorf ;
immoqqusersor	TV ;
immoqquser	TV ;
immuerulluinnar	IV ;
immuerup	IV ;
immuerutivip	XIiXmorf ;
immugip	IV ;
immugip	XIiXmorf ;
immugissi	IV ;
immug	TVschwa ;
immuiar	TV ;
immuisor	IV ;
immuisortitsi	IV ;
immuiaa	IV ;
immuiaasuu	IV ;
immuler	XIiXmorf ;
immuler	XTiXmorf ;
immulior	IV ;
immullar	IV ;
immuller	XIiXmorf ;
immulluu	IV ;
immuma	IV ;
immunikkiartor	IV ;
immunip	IV ;
immup	IV ;
immup	XItX ;
immuser	IV ;
immusersor	TV ;
immuser	TV ;
immussi	IV ;
immussuarsi	IV ;
immussuaarniar	IV ;
immussaa	IV ;
immussaajar	TV ;
immussaajaa	IV ;
immussaar	TV ;
immutilersor	TV ;
immutiler	TV ;
immuttor	IV ;
immaa	IV ;
immaakkiartor	IV ;
immaap	TV ;
immaar	IV ;
immaassor	TV ;
imoor	IV ;
imoortuinnaa	IV ;
imoqattaar	IV ;
imu	IV ;
imujoraar	IV ;
imunasuar	TV ;
imungaar	IV ;
imusi	IV ;
imusissup	XTuteXmorf ;
imusissutilaar	TV ;
imusaa	IV ;
imu	TV ;
imaaginnaler	XIiXmorf ;
imaajar	IV ;
imaajar	TV ;
imaajaa	IV ;
imaakajaar	IV ;
imaakajaarutig	TVschwa ;
imaakkajup	IV ;
imaalereer	IV ;
imaaliallaannar	TV ;
imaali	IV ;
imaalillaqqaar	IV ;
imaalior	IV ;
imaalior	TV ;
imaali	TV ;
imaangajap	IV ;
imaangajaar	IV ;
imaannaa	IV ;
imaannaanngitsukasiu	IV ;
imaannaanngitsuu	IV ;
imaanukar	IV ;
imaap	IV ;
imaar	IV ;
imaarsar	TV ;
imaarsi	IV ;
imaarsivig	TVschwa ;
imaarsaa	IV ;
imaartuinnar	IV ;
imaar	TV ;
imaarup	IV ;
imaarup	TV ;
imaarutivip	XIiXmorf ;
imaaruttoor	IV ;
imaasap	IV ;
imaasi	IV ;
imaasi	TV ;
imaassagaluar	IV ;
imaassinnaa	IV ;
imaattoqarsinnaa	IV ;
imaattor	IV ;
imaattor	TV ;
imaattorumaar	IV ;
imaattorumaar	TV ;
imaattuar	IV ;
imaattuarsinnar	IV ;
imaattuuser	TV ;
imaattuaannaler	XIiXmorf ;
imaavar	IV ;
inakkunnaar	TV ;
inaluarsualup	IV ;
inalugarsualup	IV ;
inalug	TVschwa ;
inalugaaralup	IV ;
inalugaaralussor	TVschwa ;
inaluaaralup	IV ;
inaluaaralussor	TVschwa ;
inangertip	IV ;
inangertip	TV ;
inanger	TV ;
inanger	XTiXmorf ;
inangii	IV ;
inangiisulii	IV ;
inap	TV ;
inassutig	TVschwa ;
inassutaa	IV ;
inatseriip	XItsXmorf ;
inatsi	IV ;
inatsilluar	IV ;
inatsisig	TVschwa ;
inatsisilior	IV ;
inatsisiliortuu	IV ;
inatsisitaar	IV ;
inatsissutig	TVschwa ;
inatsisaa	IV ;
inatsisaap	IV ;
inatsisaappallaar	IV ;
inatsisaap	XItsXmorf ;
inatsisaatsuu	IV ;
inatsisaatsuuniar	IV ;
inattaqattaap	XIuteXmorf ;
inattaqattaar	IV ;
inattaqattaatiinnar	XIPXmorf ;
indiamiuu	IV ;
ineqarfig	TVschwa ;
ineqatigiip	XIPXmorf ;
ineqatig	TVschwa ;
ineqataa	IV ;
inequginnip	IV ;
inequg	TVschwa ;
inequnapajup	IV ;
inequnaq	K ;
inequnar	IV ;
inequnat	K ;
inequnaap	IV ;
inequnaappallaar	IV ;
inequnaap	XItsXmorf ;
inequp	IV ;
inequp	TV ;
inequssuup	TV ;
inequssuussi	IV ;
inequsungaar	IV ;
inequsup	IV ;
inequtsaap	XTuteXmorf ;
inequtsaassi	IV ;
inequtsaativip	XTiXmorf ;
inerallar	IV ;
inerallar	TV ;
ineraluar	IV ;
ineraluar	TV ;
inerap	IV ;
inerap	TV ;
ineraqattaar	TV ;
inerar	IV ;
inerar	TV ;
inerasuar	IV ;
inerasuar	TV ;
inerasuaa	IV ;
inereer	IV ;
inereer	XTiXmorf ;
inereruttor	IV ;
ineriartorner	IV ;
ineriartortip	TV ;
ineriartortitsi	IV ;
inerikkiartor	IV ;
inerilluar	IV ;
inerip	IV ;
inerip	XIiXmorf ;
inerisar	TV ;
inerisaa	IV ;
ineritip	TV ;
inerititaqarluar	IV ;
inerititarsior	TV ;
inerititaarup	IV ;
iner	IV ;
inerluar	IV ;
inerluar	TV ;
inerner	TVschwa ;
inersimaler	XIiXmorf ;
inersimangajap	IV ;
inersimasorpalaar	IV ;
inersimasunnguler	XIiXmorf ;
inersimasuu	IV ;
inerteqqutigineqartussaa	IV ;
inerteqqutig	TVschwa ;
inerteqqutaagaluar	IV ;
inerteqqutaa	IV ;
inerterigaluar	IV ;
inerteri	IV ;
inerterisaraluar	IV ;
inerteriuaraluar	IV ;
inerterseriar	IV ;
inerterseriip	XItsXmorf ;
inerter	TV ;
inerterutig	TVschwa ;
inerter	XTiXmorf ;
inertigassaa	IV ;
inertigassaanngivip	IV ;
inertiteri	IV ;
inertiter	TV ;
inertor	TV ;
iner	TV ;
inerumaar	IV ;
inerumaar	TV ;
iner	XTiXmorf ;
ineraar	TV ;
ingakkujoq	K ;
ingalap	IV ;
ingalap	TV ;
ingalassaa	IV ;
ingalatser	TV ;
ingap	IV ;
ingappallaar	IV ;
ingasaginar	IV ;
ingasaluatsiar	IV ;
ingasap	IV ;
ingasappallaar	IV ;
ingasap	TV ;
ingasattajaari	IV ;
ingasattajaar	IV ;
ingasattajaarpallaar	IV ;
ingasavip	IV ;
ingasaap	TV ;
ingasaassi	IV ;
ingasaassinaveersaar	IV ;
ingasaassivallaar	IV ;
ingatsikkaluttuinnar	IV ;
ingatsikkiartor	IV ;
ingatsikkiartuinnar	IV ;
ingatsip	IV ;
ingatsip	TV ;
ingattarser	IV ;
ingattarter	IV ;
ingattavip	XIiXmorf ;
ingattaap	TV ;
ingattaassi	IV ;
ingeer	IV ;
ingeersar	IV ;
ingeersar	TV ;
ingeniøriu	IV ;
ingeqqusi	IV ;
ingeqqu	TV ;
ingerla	IV ;
ingerlajuar	IV ;
ingerlajumajunnaar	IV ;
ingerlajumaar	IV ;
ingerlajunnaar	IV ;
ingerlakkunnaar	TV ;
ingerlalluar	IV ;
ingerlalluarneru	IV ;
ingerlalluarneruler	XIiXmorf ;
ingerlalluar	TV ;
ingerlaluusaar	IV ;
ingerlaniataar	IV ;
ingerlaniup	XTuteXmorf ;
ingerlap	TV ;
ingerlaqasiup	TV ;
ingerlaqatigiip	XIPXmorf ;
ingerlaqatig	TVschwa ;
ingerlaqataa	IV ;
ingerlarsor	IV ;
ingerlarujutaar	IV ;
ingerlasinnaagaluar	IV ;
ingerlasinnaa	IV ;
ingerlasinnaajunnaar	IV ;
ingerlassi	IV ;
ingerlassinnaagaluar	TV ;
ingerlassinnaa	TV ;
ingerlasaar	TV ;
ingerlatar	TVschwa ;
ingerlatiinnar	TV ;
ingerlatiinnavip	XIiXmorf ;
ingerlatip	TV ;
ingerlatitsi	IV ;
ingerlatitsisuu	IV ;
ingerlatitaa	IV ;
ingerlatsi	IV ;
ingerlatsisinnaagaluar	IV ;
ingerlatsisinnaa	IV ;
ingerlatsisinnaaner	IV ;
ingerlatsisinnaatitaa	IV ;
ingerlatsisuu	IV ;
ingerla	TV ;
ingerlavigineqarsinnaa	IV ;
ingerlavig	TVschwa ;
ingerlavikuatigoor	IV ;
ingerlup	IV ;
ingerlaannar	IV ;
ingerlaannartunngortip	TV ;
ingerlaannartunngortitsip	TV ;
ingerlaar	IV ;
ingerlaartip	IV ;
ingerlaasaar	IV ;
ingermip	IV ;
ingeruloor	IV ;
ingeruloortip	TV ;
ingerulup	IV ;
ingiallortar	TVschwa ;
ingiallor	TV ;
ingiallortaa	IV ;
ingiallui	IV ;
ingialluup	IV ;
ingiaqasiup	IV ;
ingiaqasiup	TV ;
ingiaqatigiip	XIPXmorf ;
ingiaqatig	TVschwa ;
ingiaqattaa	IV ;
ingiaqataa	IV ;
ingiaquttaap	IV ;
ingiaquttaap	TV ;
ingiarngusaap	IV ;
ingiarniu	XIPXmorf ;
ingiarsaar	TVschwa ;
ingiar	TV ;
ingiarumaar	TV ;
ingiffig	TVschwa ;
ingiffissaarup	IV ;
ingimip	IV ;
ingimip	TV ;
ingimitip	TV ;
ingimitsip	TV ;
ingimittoor	IV ;
ingiorluar	TV ;
ingiortigiip	XIPXmorf ;
ingiortig	TVschwa ;
ingior	TV ;
ingiortaa	IV ;
ingipiloor	IV ;
ingip	IV ;
ingitip	TV ;
ingitseri	IV ;
ingitser	IV ;
ingitsertagaa	IV ;
ingitsertuinnaa	IV ;
ingitser	TV ;
ingitsigassaa	IV ;
ingitsigassaannaa	IV ;
ingitsigaa	IV ;
ingitsila	IV ;
ingitsilajunnaar	IV ;
ingiui	IV ;
ingiuleerup	XIuteXmorf ;
ingiuleerutivip	XIiXmorf ;
ingiuligaar	IV ;
ingiulip	IV ;
ingiulissior	IV ;
ingiulissuar	IV ;
ingiulittorsuu	IV ;
ingiullerajup	IV ;
ingiullerajussi	IV ;
ingiullersorsuanngor	IV ;
ingiullersorsuu	IV ;
ingiuller	XIiXmorf ;
ingivip	XIiXmorf ;
ingiaa	IV ;
inguffig	TVschwa ;
ingu	IV ;
ingumip	IV ;
ingumip	TV ;
ingumitip	TV ;
ingumitsip	TV ;
ingumittoor	IV ;
ingup	TV ;
ingusoor	IV ;
ingusoor	TV ;
ingussip	TV ;
ingussisi	TV ;
ingussittaa	IV ;
ingussorar	IV ;
ingussor	IV ;
ingutseri	IV ;
ingutserisar	IV ;
ingutser	IV ;
ingutsertagaa	IV ;
ingutsertuinnaa	IV ;
ingutser	TV ;
ingutsigassaa	IV ;
ingutsigassaannaa	IV ;
ingutsigaa	IV ;
ingutsi	IV ;
ingutsila	IV ;
ingutsilajunnaar	IV ;
inigineqarsinnaa	IV ;
iniginerusartag	TVschwa ;
inigip	IV ;
inigip	XIiXmorf ;
inigissi	IV ;
inigissaar	IV ;
inigissaarpallaar	IV ;
inig	TVschwa ;
inikilli	IV ;
inikillior	IV ;
inikillisaar	TV ;
inikilli	TV ;
inikilliuup	IV ;
inikip	IV ;
inikip	XItsXmorf ;
inikitsunnguu	IV ;
inikitsuu	IV ;
inikkuminar	IV ;
inileri	IV ;
inilertor	IV ;
inilertor	TV ;
iniler	XIiXmorf ;
iniler	XTiXmorf ;
inilior	IV ;
inilior	TV ;
inilip	IV ;
inilissi	IV ;
inilukkunnaar	IV ;
inilulluinnar	IV ;
inilup	IV ;
inilussi	IV ;
inimiutaa	IV ;
iningajaler	IV ;
iningajaler	XTiXmorf ;
inioqqar	TV ;
inioqqaser	IV ;
inioqqasersor	IV ;
inioqqasersor	TV ;
inioqqaser	XTiXmorf ;
inioqqaagajup	IV ;
inioqqaa	IV ;
inioqqaasaannar	IV ;
inioraagajup	IV ;
inipalaar	IV ;
inipalaar	TV ;
inisiffig	TVschwa ;
inisiffissaarup	IV ;
inisi	IV ;
inisimasuu	IV ;
inisimmaveerup	IV ;
inisimmavikip	IV ;
inisimmavikip	XItsXmorf ;
inisimmavissaarup	IV ;
inisivig	TVschwa ;
inissaqartip	IV ;
inissaqartip	TV ;
inissaqqip	IV ;
inissaqqip	TV ;
inissaqqip	XIiXmorf ;
inissarsi	IV ;
inissarsioraluar	IV ;
inissarsioraluar	TV ;
inissarsior	IV ;
inissarsior	TV ;
inissarsissup	TV ;
inissarsi	TV ;
inissaaleqip	IV ;
inissaaleqisip	TV ;
inissaaleqisup	TV ;
inissaannaa	IV ;
inissaarup	IV ;
inissaarup	TV ;
inissaasua	IV ;
inissaasuatip	TV ;
inissaasuatitaa	IV ;
initoorsuu	IV ;
inittor	IV ;
inittorsar	TV ;
inittortip	TV ;
inittor	TV ;
inituallaar	IV ;
initu	IV ;
initunersaa	IV ;
initunaar	TV ;
initusi	IV ;
ini	TV ;
iniusar	IV ;
inivip	IV ;
inivip	TV ;
inivissinnaa	IV ;
innajuu	IV ;
innajaallu	IV ;
innajaallusi	IV ;
innajaar	IV ;
innajaarniar	IV ;
innakujuinnaa	IV ;
innakujuuinnaa	IV ;
innanga	IV ;
innanganertuallaar	IV ;
innanganertu	IV ;
innanngavissior	IV ;
innanngavissior	TV ;
innanngavissaarup	IV ;
innap	IV ;
innaqatsi	IV ;
innarasuar	IV ;
innar	IV ;
innarlersip	TV ;
innarler	XIiXmorf ;
innarler	XTiXmorf ;
innarlior	IV ;
innarlitsaalior	TV ;
innarlitsaaliui	IV ;
innarliup	IV ;
innarluip	IV ;
innarluip	XItsXmorf ;
innarluissutissar	TVschwa ;
innarlulaar	IV ;
innarlummoor	IV ;
innarlummoor	TV ;
innarlup	IV ;
innarluutig	TVschwa ;
innarluutaa	IV ;
innarnerlior	IV ;
innarsior	IV ;
innartarfig	TVschwa ;
innartar	IVschwa ;
innartip	TV ;
innartor	IV ;
innarumagaluar	IV ;
innaruma	IV ;
innarumaarnertu	IV ;
innarumaataar	IV ;
inneerser	IV ;
inneri	IV ;
innerinnarsuanngor	IV ;
innerituallaar	IV ;
inner	IV ;
innersi	IV ;
innersor	TV ;
innersuup	TV ;
innersuussigaluar	IV ;
innersuussi	IV ;
inneruula	IV ;
inneruularnip	IV ;
inner	XTiXmorf ;
innganersior	IV ;
innganersior	TV ;
inngasup	IV ;
inngeerulluinnar	IV ;
inngeerup	IV ;
innger	IV ;
inngersuu	IV ;
inngertaar	IV ;
inngerusior	IV ;
inngerusaar	IV ;
inngiag	TVschwa ;
inngianar	IV ;
inngianarpallaar	IV ;
inngiar	IV ;
inngiar	TV ;
inngiartaannar	IV ;
inngiasup	IV ;
inngigeqqissaar	IV ;
inngigip	IV ;
inngigip	XIiXmorf ;
inngigissar	TV ;
inngigissaa	IV ;
inngiiar	TV ;
inngiiartaannar	XIPXmorf ;
inngiiar	XIPXmorf ;
inngikip	XItsXmorf ;
inngikujoorsuu	IV ;
inngillup	IV ;
inngip	TV ;
inngiulaar	IV ;
inngaallap	IV ;
inngaalup	IV ;
inniar	IV ;
inniffig	TVschwa ;
innigiar	IV ;
innimig	TVschwa ;
innimiillior	IV ;
innimiip	IV ;
innimiiser	IV ;
inniminar	IV ;
inniminner	TV ;
inniminnii	IV ;
innimisunnar	IV ;
innimisup	IV ;
inningiannar	IV ;
inningiap	IV ;
inninnip	IV ;
innip	IV ;
innisalersor	TV ;
innissiffig	TVschwa ;
innissiaa	IV ;
innitsersor	TV ;
inniuser	IV ;
inniuser	XTiXmorf ;
inniutaa	IV ;
inniutaarser	IV ;
innorlup	IV ;
innuarsaaler	IV ;
innuarsaar	IV ;
innup	IV ;
innussor	XIPXmorf ;
innuttar	TVschwa ;
innuttaa	IV ;
innaa	IV ;
innaajunnarsi	IV ;
innaallap	IV ;
innaalup	IV ;
innaaluttuar	IV ;
innaaluttuinnaa	IV ;
innaanganermukar	IV ;
innaanganiliar	IV ;
innaannaa	IV ;
innaap	TV ;
innaaqqilluinnar	IV ;
innaaqqip	IV ;
innaaqqip	XIiXmorf ;
innaaqqissuinnaa	IV ;
innaariar	IV ;
innaarsuinnarsuu	IV ;
innaarsuinnaa	IV ;
innaarsunnukar	IV ;
innaassi	IV ;
innaassaa	IV ;
inooqatigiip	XIPXmorf ;
inoorsaar	IV ;
inoorsaar	TV ;
inoqanngivip	XIiXmorf ;
inoqarissaa	IV ;
inoqarner	IV ;
inoqasiup	TV ;
inoqataa	IV ;
inoqqiu	IV ;
inoqusiup	TV ;
inoqutaa	IV ;
inorer	IV ;
inorersorsuu	IV ;
inoriaqqoriartor	IV ;
inoriar	IV ;
inor	IV ;
inorluu	IV ;
inornar	IV ;
inoroor	IV ;
inoroorsaarfiginnip	IV ;
inoroorsaarfig	TVschwa ;
inoroorsaar	IV ;
inoror	IV ;
inororsarfig	TVschwa ;
inororsar	IV ;
inororsar	TV ;
inororsaa	IV ;
inororuttuler	XIiXmorf ;
inorroor	IV ;
inorroortitsi	IV ;
inorsarfig	TVschwa ;
inorsar	IV ;
inorsaatig	TVschwa ;
inortaler	XTiXmorf ;
inortor	TV ;
inortuigajup	IV ;
inortui	IV ;
inortusungar	TV ;
inortuup	XIuteXmorf ;
inortuup	XTuteXmorf ;
inortuutiler	XIiXmorf ;
inor	TV ;
inorujussuu	IV ;
inoruutitor	IV ;
inspektøriu	IV ;
inuaqerpalup	IV ;
inuaqi	IV ;
inuarajup	IV ;
inuarajuttorsuu	IV ;
inuar	IV ;
inuarsaaler	XIiXmorf ;
inuarsaar	IV ;
inuartoqartip	TV ;
inuaraa	IV ;
inuer	IV ;
inuerniar	IV ;
inuerniaa	IV ;
inuerup	IV ;
inuerup	TV ;
inuerussor	XIPXmorf ;
inuer	XTiXmorf ;
inugallaqqip	XIiXmorf ;
inugarajup	IV ;
inugar	IV ;
inugasaar	IV ;
inugasaarunnaar	IV ;
inugiap	IV ;
inugip	XIiXmorf ;
inugititaa	IV ;
inug	TVschwa ;
inugaarup	IV ;
inuiap	IV ;
inuiar	TV ;
inuilatsi	IV ;
inuilatsinar	IV ;
inuilli	IV ;
inuilaarsior	IV ;
inuinnaa	IV ;
inuisap	IV ;
inuiaa	IV ;
inukinaar	TV ;
inukkoor	IV ;
inukkoor	TV ;
inukkutiginnip	IV ;
inukkutigisaa	IV ;
inukkutig	TVschwa ;
inukkutillii	IV ;
inukkaap	TV ;
inukullerajup	IV ;
inukuller	XIiXmorf ;
inukulliatari	IV ;
inuleri	IV ;
inulerituallaar	IV ;
inuleritu	IV ;
inulersor	TV ;
inulersui	IV ;
inuliar	IV ;
inulimmukar	IV ;
inulimmukaap	TV ;
inulimmukaassi	IV ;
inulip	IV ;
inulup	IV ;
inuluugajup	IV ;
inuluuginnip	IV ;
inuluug	TVschwa ;
inuluu	IV ;
inuluusaannar	IV ;
inuminertor	IV ;
inummataa	IV ;
inunga	IV ;
inungaaffig	TVschwa ;
inungaallior	IV ;
inungaap	XItsXmorf ;
inunikkiartor	IV ;
inunip	IV ;
inunippallaar	IV ;
inunngorfig	TVschwa ;
inunngor	IV ;
inunnguuser	TVschwa ;
inunnukar	IV ;
inupalaa	IV ;
inupalaanngor	IV ;
inupalaar	IV ;
inupalaarsuu	IV ;
inupilussiar	TVschwa ;
inupilussuu	IV ;
inupilussuusaar	IV ;
inupiluu	IV ;
inupiluuser	IV ;
inuppalup	IV ;
inuppalaar	IV ;
inuppassuu	XIPXmorf ;
inuppaa	IV ;
inuppaalussuu	IV ;
inup	TV ;
inussar	IV ;
inussar	TVschwa ;
inussiarnerfig	TVschwa ;
inussiarner	IV ;
inussiarnersorsuu	IV ;
inussiarnersaarfig	TVschwa ;
inussiarnersaar	IV ;
inussiarniilikaar	IV ;
inussiarniilli	IV ;
inussiarniip	XItsXmorf ;
inussi	IV ;
inussior	IV ;
inussiaa	IV ;
inussiaarniar	IV ;
inussukkior	IV ;
inussulior	IV ;
inussunni	K ;
inussunnip	IV ;
inussuppalaar	IV ;
inussaaniar	IV ;
inutsigoor	TV ;
inuttalerneqanngikkallar	IV ;
inuttaler	TV ;
inuttar	TVschwa ;
inuttassarsi	IV ;
inuttassarsior	IV ;
inuttassarsior	TV ;
inuttassarsiui	IV ;
inuttassarsiuisarfiu	IV ;
inuttassarsiuussi	IV ;
inuttassarsiuuteqqip	TV ;
inuttoor	IV ;
inuttor	IV ;
inuttu	IV ;
inuttusiartoqqiler	XIiXmorf ;
inuttusiartor	IV ;
inuttusi	IV ;
inuttuuma	IV ;
inuttaa	IV ;
inuttaasar	IV ;
inuuar	IV ;
inuuarsinnar	IV ;
inuueqatigiip	XIPXmorf ;
inuueqatig	TVschwa ;
inuuffig	TVschwa ;
inuugujoq	K ;
inuuissior	IV ;
inuu	IV ;
inuujuar	IV ;
inuujuarsinnar	IV ;
inuujuaar	IV ;
inuukkunnaar	IV ;
inuukkunnaar	XIiXmorf ;
inuuleqqip	IV ;
inuuleqqip	XIiXmorf ;
inuuleqqissip	TV ;
inuuler	XIiXmorf ;
inuulluaqqusi	IV ;
inuulluaqqussutig	TVschwa ;
inuulluaqqu	TV ;
inuulluar	IV ;
inuulluarnerlup	IV ;
inuulluarnaap	XItsXmorf ;
inuulluartip	TV ;
inuulluartitsi	IV ;
inuulluataar	IV ;
inuulluataartip	TV ;
inuulluataartitsi	IV ;
inuulluataarutig	TVschwa ;
inuulluutig	TVschwa ;
inuulluutaa	IV ;
inuulluaatig	TVschwa ;
inuulluaataa	IV ;
inuuluttaar	IV ;
inuummarikkunnaar	XIiXmorf ;
inuummarinnar	IV ;
inuummarip	XIiXmorf ;
inuummarissar	IV ;
inuummarissar	TV ;
inuummarissi	IV ;
inuummarissinar	IV ;
inuummarissaar	IV ;
inuummarissaatig	TVschwa ;
inuummarlior	IV ;
inuummersoqqu	TV ;
inuummersor	IV ;
inuummersuutig	TVschwa ;
inuunar	IV ;
inuunerip	IV ;
inuunerip	XIiXmorf ;
inuunerissi	IV ;
inuunerlup	IV ;
inuunertoorsuu	IV ;
inuunertu	IV ;
inuunertuneru	IV ;
inuunertusiartor	IV ;
inuunertusigaluttuinnar	IV ;
inuunikip	XItsXmorf ;
inuunnguarpap	IV ;
inuupalaar	IV ;
inuup	IV ;
inuusalior	IV ;
inuusar	IV ;
inuusartaar	IV ;
inuuserip	XIiXmorf ;
inuuserlerajup	IV ;
inuuserlersar	IV ;
inuuserler	XIiXmorf ;
inuuserlior	IV ;
inuuserlup	IV ;
inuuser	TVschwa ;
inuussuteqartip	TV ;
inuussutig	TVschwa ;
inuussutissarsior	IV ;
inuussutissarsiutig	TVschwa ;
inuussutissarsiutitaar	IV ;
inuussutaa	IV ;
inuusukanner	IV ;
inuusukkallar	IV ;
inuusukaaju	IV ;
inuusunnerugallar	IV ;
inuusunneru	IV ;
inuusup	IV ;
inuusuppallaar	IV ;
inuusuppallaarunnaar	XIiXmorf ;
inuusuppalup	IV ;
inuusuppalussi	IV ;
inuusussi	IV ;
inuusussaatig	TVschwa ;
inuusuttorpassuu	XIPXmorf ;
inuusuttuaraa	IV ;
inuusuttuu	IV ;
inuusaar	IV ;
inuusaartip	TV ;
inuutig	TVschwa ;
inuutissarsior	IV ;
inuutissarsiorsinnaajunnaar	XIiXmorf ;
inuutissarsiutigivip	XTiXmorf ;
inuutissarsiutig	TVschwa ;
inuutissarsiutitaar	IV ;
inuutivip	XIiXmorf ;
inuutsap	IV ;
inuutsarip	XIiXmorf ;
inuutsarissi	IV ;
inuutsarlup	IV ;
inuutsaruttor	IV ;
inuutsassutig	TVschwa ;
inuutsorlup	IV ;
inuutsorlussi	IV ;
inuuttoor	IV ;
inuuttuinnar	IV ;
inuuaar	IV ;
inaalii	IV ;
inaalilluar	TV ;
inaalip	IV ;
inaalip	TV ;
inaalisiter	TV ;
inaallagissamoor	IV ;
inaannaror	TV ;
inaannar	TV ;
inaannaa	IV ;
inaarsar	TV ;
inaarsi	IV ;
inaarsaa	IV ;
inaarsaatip	TV ;
inaar	TV ;
inaasar	IV ;
inaasua	IV ;
ipagilluinnar	IV ;
ipagip	XIiXmorf ;
ipagissaar	IV ;
ipaguarsar	TV ;
ipaguaar	IV ;
ipajaar	IV ;
ipakilluinnar	IV ;
ipakip	XItsXmorf ;
ipallup	IV ;
ipaqqarip	XIiXmorf ;
ipaqqer	XTiXmorf ;
iparartorsar	TVschwa ;
iparartor	TV ;
iparar	TV ;
ipattu	IV ;
ipeerluer	IV ;
ipeerluernar	IV ;
ipeerluer	TV ;
ipeerluer	XTiXmorf ;
ipeersaagaa	IV ;
ipeersaar	IV ;
ipeersaartuu	IV ;
ipeersaarup	TV ;
ipeerulluinnar	IV ;
ipeerup	XIuteXmorf ;
ipeerusar	TV ;
ipeerutivip	XIiXmorf ;
ipeqanngivip	XIiXmorf ;
ipeqqa	IV ;
ipeqqareer	IV ;
ipeqqarip	XIiXmorf ;
ipeqqarissi	IV ;
ipeqqersor	TV ;
ipeqqersui	IV ;
ipeqqer	TV ;
ipeqqii	IV ;
ipeqqiup	TV ;
iperagaa	IV ;
iperagaalluinnar	IV ;
iperarsar	TVschwa ;
iperartoor	TV ;
iperartor	IV ;
iperartorsar	TVschwa ;
iperartor	TV ;
iperartui	IV ;
iperartullaqqip	XIiXmorf ;
iperar	TV ;
iperartaar	IV ;
ipereersimagaluar	IV ;
ipereer	XIiXmorf ;
iperiikatap	IV ;
iperinnerussaar	IV ;
iperinnerussaar	TV ;
iperip	XIiXmorf ;
iperisip	TV ;
iperisitsi	IV ;
iperissip	TV ;
iper	IV ;
ipernertor	IV ;
iperruser	IV ;
ipertuallaar	IV ;
ipertu	IV ;
ipertukujup	IV ;
ipertunersaa	IV ;
ipertuuleri	IV ;
iperuulluinnar	IV ;
iperuup	IV ;
iperaa	IV ;
iperaannar	TV ;
iperaap	IV ;
iperaap	TV ;
iperaar	IV ;
iperaassor	TV ;
iperaatarsor	IV ;
iperaataarup	IV ;
ipia	IV ;
ipianar	IV ;
ipiasar	TV ;
ipigunar	IV ;
ipigunarsaa	IV ;
ipiiar	IV ;
ipiiarluar	IV ;
ipiiarluar	TV ;
ipiiar	TV ;
ipiikkunnaar	XIiXmorf ;
ipiilli	IV ;
ipiillisaar	IV ;
ipiinnaa	IV ;
ipiip	XItsXmorf ;
ipi	IV ;
ipiiaa	IV ;
ipikatarer	IV ;
ipikip	XItsXmorf ;
ipikkunar	IV ;
ipikkunnaar	IV ;
ipikujungaar	IV ;
ipikujup	IV ;
ipikujuttorsuu	IV ;
ipikaassip	IV ;
ipiler	XIiXmorf ;
ipingajap	IV ;
ipip	IV ;
ipip	TV ;
ipisar	TV ;
ipissar	TV ;
ipissi	IV ;
ipissivip	XIiXmorf ;
ipissaa	IV ;
ipisaanngu	IV ;
ipitaqqup	IV ;
ipitaqqup	TV ;
ipitaqqutaar	IV ;
ipiteri	IV ;
ipiterillaqqip	XIiXmorf ;
ipiterusiup	XTuteXmorf ;
ipiterutaajar	IV ;
ipiter	XTiXmorf ;
ipitip	TV ;
ipitsi	IV ;
ipittaa	IV ;
ipittaaser	TV ;
ipiutakip	XItsXmorf ;
ip	IV ;
ipivip	XIiXmorf ;
iporsuup	XIPXmorf ;
iporsuup	XTPXmorf ;
iporsuuttorsuu	XIPXmorf ;
ippaja	IV ;
ippajaap	XItsXmorf ;
ippakkaluttuinnar	IV ;
ippalluinnar	IV ;
ippalup	IV ;
ippalup	TV ;
ippammiitip	TV ;
ippap	IV ;
ippappallaar	IV ;
ippap	TV ;
ippaqqissaar	IV ;
ippaqqissaar	TV ;
ippar	IV ;
ippar	TV ;
ippasior	IV ;
ippassi	IV ;
ippassaa	IV ;
ippassaavallaar	IV ;
ippatilior	IV ;
ippatsip	TV ;
ippeqi	IV ;
ippeqinar	IV ;
ippeqivallaar	IV ;
ippernaarsaar	IV ;
ippersor	TV ;
ippertuallaar	IV ;
ippertu	IV ;
ippertunersaa	IV ;
ipper	XTiXmorf ;
ippigar	IV ;
ippiginnip	IV ;
ippigisaarup	XIuteXmorf ;
ippigisaarutivip	XIiXmorf ;
ippig	IVschwa ;
ippig	TVschwa ;
ippigusup	IV ;
ippikar	IV ;
ippikar	TV ;
ippikip	IV ;
ippikip	XItsXmorf ;
ippikitsunnguu	IV ;
ippikaap	IV ;
ippingiag	TVschwa ;
ippingianar	IV ;
ippingiap	IV ;
ippingiator	IV ;
ippingiatornaraluar	IV ;
ippingiatornar	IV ;
ippingiatuutig	TVschwa ;
ippinnar	IV ;
ippinnarsi	IV ;
ippinnartoqartip	TV ;
ippinnarunnaar	XIiXmorf ;
ippinnaatig	TVschwa ;
ippior	IV ;
ippisar	IV ;
ippisaar	IV ;
ipporip	IV ;
ipporippallaar	IV ;
ipporip	XIiXmorf ;
ipporissi	IV ;
ipporissivip	XIiXmorf ;
ipporissaar	IV ;
ipporlukkunnaar	XIiXmorf ;
ipporlup	IV ;
ipporluppallaar	IV ;
ipporluttuiu	IV ;
ippuissaar	IV ;
ippulluinnar	TV ;
ippup	IV ;
ippup	TV ;
ippuser	IV ;
ipputingajap	TV ;
ipputivip	TV ;
ipputtuu	IV ;
ippaakkaluttuinnar	IV ;
ippaalluinnar	IV ;
ippaap	IV ;
ippaappallaar	IV ;
ippaap	TV ;
ip	TV ;
ipuarip	XIiXmorf ;
ipuerup	XIuteXmorf ;
ipuerutivip	XIiXmorf ;
ipueruttoor	IV ;
ipugip	IV ;
ipugip	XIiXmorf ;
ipuinnar	IV ;
ipulersor	TV ;
ipuler	TV ;
ipuler	XIiXmorf ;
ipulikker	TV ;
ipulittatuaa	IV ;
ipullaqqip	XIiXmorf ;
ipullaqqissi	IV ;
ipullaqqissivip	XIiXmorf ;
ipulutakip	XItsXmorf ;
ipummer	IV ;
ipummerluar	IV ;
ipummersip	TV ;
ipumminga	IV ;
ipummingavip	XIiXmorf ;
ipummiup	TV ;
ipummiussi	IV ;
ipup	IV ;
ipup	TV ;
ipuserfilersor	TV ;
ipuserfilersui	IV ;
ipusersor	IV ;
ipuser	XTiXmorf ;
ipusiuup	TV ;
ipussinnaa	IV ;
ipussorataar	IV ;
ipussaar	IV ;
ipussaartitsi	IV ;
iputiler	XIiXmorf ;
iputilior	IV ;
iputisseri	IV ;
iputissiaa	IV ;
iputissaa	IV ;
iputseriip	XItsXmorf ;
iputtaa	IV ;
iputaa	IV ;
iputaajarajup	IV ;
iputaajar	IV ;
iputaajar	TV ;
iputaar	IV ;
iputaarser	IV ;
iputaar	TV ;
isaguip	XItsXmorf ;
isagup	TV ;
isa	IV ;
isajanngap	TV ;
isajanngassi	IV ;
isap	IV ;
isap	TV ;
isaqqajaa	IV ;
isaqqi	IV ;
isaqqila	IV ;
isaqqillap	IV ;
isaqqilaar	IV ;
isaqup	IV ;
isareer	IV ;
isarortip	IV ;
isaror	TV ;
isarualeri	IV ;
isarualer	XIiXmorf ;
isarualior	IV ;
isarualiortuu	IV ;
isaruariar	IV ;
isaruar	IV ;
isaruar	TV ;
isarui	IV ;
isarusser	IV ;
isarussior	IV ;
isarussiortuu	IV ;
isaruaajar	IV ;
isasoor	IV ;
isassi	IV ;
isassorartor	IV ;
isatakip	XItsXmorf ;
isateqqajaa	IV ;
isateri	IV ;
isater	XTiXmorf ;
isatsip	TV ;
isatsuip	XItsXmorf ;
isattor	IV ;
isattor	TV ;
isattaap	IV ;
iseqqa	IV ;
iseqqimisaar	IV ;
iseqqi	TV ;
iseqqiusaar	IV ;
iseqqortu	IV ;
iseqqumisaar	IV ;
iseqqaanniuup	XIPXmorf ;
iserartor	IV ;
iserasuar	IV ;
iserasug	TVschwa ;
iseratannguar	IV ;
iserfig	TVschwa ;
iserfikip	XItsXmorf ;
iserialaar	IV ;
iserianip	IV ;
iseriap	IV ;
iseriattorsuu	IV ;
iserisser	IV ;
iseriusaar	IV ;
iser	IV ;
iserniannguar	IV ;
iserniup	IV ;
isersarnerajup	IV ;
isersarner	IV ;
isersarnaannguar	IV ;
isersimakatap	IV ;
isersimakatavip	XIiXmorf ;
isersimmaser	IV ;
isersorfig	TVschwa ;
isersor	IV ;
isersorsuu	IV ;
isertar	IVschwa ;
isertar	TVschwa ;
iserteri	IV ;
iserter	IV ;
iserter	XTiXmorf ;
isertip	TV ;
isertitaqqoortu	IV ;
isertor	IV ;
isertor	TV ;
isertuar	IV ;
isertugaa	IV ;
isertugaarup	TV ;
isertui	IV ;
isertuiui	IV ;
isertuiuip	XItsXmorf ;
isertuiuitsuu	IV ;
isertujui	IV ;
isertujuip	XItsXmorf ;
isertujuitsuu	IV ;
isertukkujup	IV ;
isertuup	XTuteXmorf ;
isertuussi	IV ;
iser	TV ;
iser	XTiXmorf ;
isiffallap	IV ;
isiffallap	TV ;
isiffissaannaa	IV ;
isiffiusar	IV ;
isigakip	XItsXmorf ;
isigammip	TV ;
isigap	TV ;
isigassor	IV ;
isigattoorsuu	IV ;
isigattu	IV ;
isigerlup	TV ;
isigeruloor	IV ;
isigeruloor	TV ;
isigerulup	TV ;
isigiarsup	IV ;
isigiarsup	TV ;
isigi	IV ;
isigilluariar	TV ;
isigilluar	IV ;
isigilluarsinnaa	IV ;
isigilluarsinnaa	TV ;
isigilluar	TV ;
isigilluarunnaar	XIiXmorf ;
isigineqarsinnaa	IV ;
isiginer	TVschwa ;
isiginnartitsinerpalaar	IV ;
isiginngitsuusaar	IV ;
isiginngitsuusaar	TV ;
isiginnip	IV ;
isiginnip	TV ;
isiginnittuu	IV ;
isiginnaagassialior	IV ;
isiginnaagassiaa	IV ;
isiginnaariar	IV ;
isiginnaar	IV ;
isiginnaartip	IV ;
isiginnaartip	TV ;
isiginnaartitsi	IV ;
isiginnaartitsisartuu	IV ;
isiginnaar	TV ;
isigip	IV ;
isigip	XIiXmorf ;
isigisassiarinnip	IV ;
isigisoor	TV ;
isigissi	IV ;
isigissoortip	IV ;
isigissoortip	TV ;
isigissuu	IV ;
isigissaa	IV ;
isigisuui	IV ;
isigisuu	IV ;
isigitip	TV ;
isigiuminar	IV ;
isigiuminarsi	IV ;
isigiuminaap	XItsXmorf ;
isig	IVschwa ;
isig	TVschwa ;
isigaaler	XIiXmorf ;
isigaalivip	IV ;
isigaarsigajup	IV ;
isigaarsiisar	IV ;
isigaarsi	IV ;
isigaarsilaar	IV ;
isi	IV ;
isikig	TVschwa ;
isikilli	IV ;
isikippallaar	IV ;
isikip	XItsXmorf ;
isikkanilinngor	TV ;
isikkanner	XTPXmorf ;
isikkannii	IV ;
isikkanniup	TV ;
isikkanniussi	IV ;
isikkar	IV ;
isikkartip	TV ;
isikkileer	IV ;
isikkileersip	TV ;
isikkileersitsi	IV ;
isikkiveerup	IV ;
isikkiveerup	TV ;
isikkivigip	XIiXmorf ;
isikkivigissi	IV ;
isikkivigissiler	XIiXmorf ;
isikkivikilliartor	IV ;
isikkivikip	XItsXmorf ;
isikkivittu	IV ;
isikkorip	XIiXmorf ;
isikkorissi	IV ;
isikkorlup	IV ;
isikkorlup	TV ;
isikkortuallaar	IV ;
isikkortuip	XIiXmorf ;
isikkortu	IV ;
isikkulup	IV ;
isikkuminar	IV ;
isikkuminarsi	IV ;
isikkunip	IV ;
isikkup	IV ;
isikkup	TV ;
isikkussaqar	XIPXmorf ;
isikkaartip	TV ;
isikujoorfig	TVschwa ;
isikujoor	IV ;
isikula	IV ;
isikulajunnaar	IV ;
isikula	TV ;
isileri	IV ;
isilersor	TV ;
isiler	XTiXmorf ;
isillatuar	IV ;
isillernar	IV ;
isillersar	IV ;
isillersaatig	TVschwa ;
isiller	XIiXmorf ;
isilup	IV ;
isimmarip	XIiXmorf ;
isimmar	IV ;
isimmarsar	TV ;
isimmartip	TV ;
isimmartoor	IV ;
isimmigartor	TV ;
isimmigar	TV ;
isimmigaap	IV ;
isimmikap	TV ;
isimmikattaa	IV ;
isimmip	IV ;
isimmip	TV ;
isimmissar	TV ;
isimmissaap	IV ;
isimmitsi	IV ;
isinga	IV ;
isingasoor	IV ;
isingavallaar	IV ;
isinnga	IV ;
isinngalluar	IV ;
isinngusaler	XIiXmorf ;
isinngaannar	IV ;
isip	IV ;
isippeer	XTiXmorf ;
isip	TV ;
isissarip	XIiXmorf ;
isissuar	TV ;
isissutissaleri	IV ;
isissaa	IV ;
isitaler	TV ;
isitalaar	IV ;
isitalaartip	TV ;
isitoorsuu	IV ;
isitser	IV ;
isitser	XTiXmorf ;
isitug	TVschwa ;
isiula	IV ;
isiviallap	IV ;
isiviallap	TV ;
isivip	IV ;
isivip	XIiXmorf ;
isivip	XTiXmorf ;
isivisar	TV ;
isivitip	TV ;
isoquser	TV ;
isorajup	IV ;
isorakilli	TV ;
isorakinaar	TV ;
isorakip	XItsXmorf ;
isorartu	IV ;
isorartunaarsi	IV ;
isorartunaarsinar	IV ;
isorartunaar	TV ;
isorartuu	IV ;
isorinnikkajup	IV ;
isorinnip	IV ;
isorinnippallaar	IV ;
isori	TV ;
isor	IV ;
isorliu	IV ;
isorlutakip	XItsXmorf ;
isorlutaaqi	IV ;
isorlutaaqinar	IV ;
isorlutaar	IV ;
isornar	IV ;
isornartorsior	TV ;
isornartorsiui	IV ;
isornartorsiuisar	IV ;
isornaap	XItsXmorf ;
isornaateqanngivip	XIiXmorf ;
isortikkiartor	IV ;
isortip	IV ;
isortorsuu	IV ;
isortumukar	IV ;
isor	TVschwa ;
issagaluar	IV ;
issakajaar	IV ;
issakajaartip	TV ;
issakatsiaar	IV ;
issakatsiaarrap	IV ;
issaler	XIiXmorf ;
issali	IV ;
issangeratar	IV ;
issangeriataar	IV ;
issanger	IV ;
issangersimaannaler	XIiXmorf ;
issangiar	IV ;
issangiarpallap	IV ;
issangiarpallavip	XIiXmorf ;
issangiataar	IV ;
issangisserajussi	IV ;
issangisser	IV ;
issangissertaannar	IV ;
issanngor	IV ;
issannguator	IV ;
issanngu	IV ;
issanngunar	IV ;
issannguup	TV ;
issariar	IV ;
issar	IV ;
issarpalup	IV ;
issar	TV ;
issaruser	IV ;
issaruser	XTiXmorf ;
isseerulluar	IV ;
isseerup	IV ;
isseerutivip	XIiXmorf ;
isseqarluar	IV ;
isseri	IV ;
isser	IV ;
issersor	IV ;
isser	TVschwa ;
isseruloor	IV ;
isser	XTiXmorf ;
issiaffig	TVschwa ;
issia	IV ;
issiajuar	IV ;
issiakatap	IV ;
issiakatavip	XIiXmorf ;
issiallannar	IV ;
issiallap	IV ;
issiallatsip	TV ;
issialluar	IV ;
issiallaap	TV ;
issianar	IV ;
issiap	IV ;
issiaqqissaar	IV ;
issiarrap	XIPXmorf ;
issiater	IV ;
issiaternar	IV ;
issiavig	TVschwa ;
issiaviliuup	TV ;
issiavittaar	IV ;
issiffap	IV ;
issiffarip	IV ;
issiffarip	XIiXmorf ;
issiffarissaar	IV ;
issiffarlup	IV ;
issiffatig	TVschwa ;
issi	IV ;
issiki	IV ;
issikilliartor	IV ;
issikilli	IV ;
issikip	XItsXmorf ;
issikkunnaar	XIiXmorf ;
issilluar	IV ;
issinga	IV ;
issinger	XTiXmorf ;
issingiar	TV ;
issingigassartor	IV ;
issingigaa	IV ;
issingii	IV ;
issingu	IV ;
issinnar	TV ;
issinneru	IV ;
issinngu	IV ;
issipikkunnaar	XIiXmorf ;
issipip	IV ;
issip	IV ;
issippallaanngitsuu	IV ;
issippallaar	IV ;
issisior	IV ;
issisiornar	IV ;
issisiornarunnaar	XIiXmorf ;
issitoor	IV ;
issittorsuugaluar	IV ;
issittorsuu	IV ;
issitu	IV ;
issitukulup	IV ;
issi	TV ;
issiutig	TVschwa ;
issiutaar	TV ;
issiaatartaar	IV ;
issiaatser	IV ;
issiaatsersor	IV ;
issiaatsersor	TV ;
issiaatser	TV ;
issiaavar	IV ;
issoqqer	IV ;
issoqqersor	TV ;
issoqqer	TV ;
issoqqiup	TV ;
issoqqiussuup	TV ;
issoqqaa	IV ;
issoqqaarip	XIiXmorf ;
issoqqaarissaar	TV ;
issorakip	XItsXmorf ;
issoraliup	TV ;
issoraliussuup	TV ;
issorareer	IV ;
issorar	IV ;
issorar	TV ;
issorartaar	IV ;
issoravip	XIiXmorf ;
issor	IV ;
issorsunnip	XItsXmorf ;
issorsuup	XIutePXmorf ;
issorsuussi	XIPXmorf ;
issortariar	IV ;
issortip	IV ;
issortip	TV ;
issortitalior	IV ;
issortitartor	IV ;
issoraa	IV ;
issoraajar	IV ;
issoraap	TV ;
issoraassi	IV ;
issuagassii	IV ;
issuagassip	TV ;
issuallaar	IV ;
issuar	IV ;
issuar	TV ;
issuer	TV ;
issugiup	TV ;
issugiussi	IV ;
issugiussaa	IV ;
issuip	XItsXmorf ;
issuisor	IV ;
issu	IV ;
issuleri	IV ;
issulip	IV ;
issulluar	TV ;
issulaar	IV ;
issulaartitsi	IV ;
issumeeri	IV ;
issumeer	TV ;
issungajap	IV ;
issup	IV ;
issup	TV ;
issussi	IV ;
issutassaaleqi	IV ;
issutsip	IV ;
issuttaqattaar	TV ;
issuttor	IV ;
issuttor	TV ;
issuttuup	TV ;
issuttuussi	IV ;
issuuma	IV ;
issuaaginnar	IV ;
issuaa	IV ;
issuaasior	IV ;
issaa	IV ;
issaajar	IV ;
issaallap	IV ;
issaallattuinnaa	IV ;
issaareer	IV ;
issaariikatap	IV ;
issaasap	IV ;
issaasassi	IV ;
issaasatsip	IV ;
issaasuerup	IV ;
isualaar	IV ;
isuar	IV ;
isugup	IV ;
isuguta	IV ;
isugutalaar	IV ;
isugutanar	IV ;
isugutap	IV ;
isugutattorsuu	IV ;
isugutavip	XIiXmorf ;
isugutser	IV ;
isugutser	XTiXmorf ;
isugutsiup	IV ;
isuguttarnaveeqquser	TV ;
isuguttarnaveeqquser	XTiXmorf ;
isuguttarsar	TV ;
isuguttarter	XTiXmorf ;
isuguttartip	TV ;
isuguttaap	TV ;
isugutaap	XItsXmorf ;
isugutaarser	IV ;
isugutaarser	TV ;
isugutaarser	XTiXmorf ;
isugutaarsii	IV ;
isugutaarukkiartor	IV ;
isugutaarup	IV ;
isuiar	TV ;
isuip	XItsXmorf ;
isukkar	IV ;
isukkarluar	IV ;
isukkarluinnar	TV ;
isukkartip	TV ;
isukkar	TV ;
isukkaartip	TV ;
isulip	IV ;
isullutakip	XItsXmorf ;
isulluttaar	IV ;
isullutaar	IV ;
isumagineru	TV ;
isumaginnip	IV ;
isumaginnittussaa	IV ;
isumagip	XIiXmorf ;
isumagissi	IV ;
isumagissaar	IV ;
isumagiuar	TV ;
isumagiunnaar	XTiXmorf ;
isumag	TVschwa ;
isuma	IV ;
isumakilli	IV ;
isumakillior	IV ;
isumakip	XItsXmorf ;
isumakkeerfiginnip	IV ;
isumakkeerfigisinnaa	TV ;
isumakkeerfigisaa	IV ;
isumakkeerfig	TVschwa ;
isumakkeerinnip	IV ;
isumakkeersinnaa	TV ;
isumakkeer	XTiXmorf ;
isumakkerfig	TVschwa ;
isumakker	IV ;
isumakkiiginnar	TV ;
isumakkiigaa	IV ;
isumakkii	IV ;
isumakkisser	IV ;
isumakkissiup	TV ;
isumakuller	XIiXmorf ;
isumakulliup	TV ;
isumakulunnar	IV ;
isumakulup	IV ;
isumakuluttaannar	IV ;
isumakuluuteqarpasip	XIiXmorf ;
isumakuluutig	TVschwa ;
isumalerar	IVschwa ;
isumalersui	IV ;
isumalersuiui	IV ;
isumalersuiuip	XItsXmorf ;
isumaler	XIiXmorf ;
isumalioqatigiip	XIPXmorf ;
isumalioqatigiissitalior	IV ;
isumalioqqissaar	IV ;
isumalioqqutig	TVschwa ;
isumaliorajup	IV ;
isumalior	IV ;
isumaliorsimagunaraluar	IV ;
isumaliorsimagunar	IV ;
isumaliortaaser	TVschwa ;
isumaliutigeqqissaareer	TV ;
isumaliutigeqqissaar	TV ;
isumaliutiginnip	IV ;
isumaliutig	TVschwa ;
isumaliutissii	IV ;
isumaliutissip	TV ;
isumaliutaagaluar	IV ;
isumaliutaa	IV ;
isumaliutaannaa	IV ;
isumallior	IV ;
isumalluarfig	TVschwa ;
isumalluar	IV ;
isumalluarnar	IV ;
isumalluuser	XIiXmorf ;
isumalluuteqarpallaar	IV ;
isumalluutig	TVschwa ;
isumalluutaa	IV ;
isumalup	IV ;
isumaluttorsuu	IV ;
isumamineeri	IV ;
isumamineer	IV ;
isumamineer	TV ;
isumamineer	XTiXmorf ;
isumanerluffig	TVschwa ;
isumanerlup	IV ;
isumanerluutig	TVschwa ;
isumannar	IV ;
isumannarsi	IV ;
isumannarsivip	XIiXmorf ;
isumannarunnaar	XTiXmorf ;
isumanngikkaluar	IV ;
isumannaajar	TV ;
isumannaajaa	IV ;
isumannaallisar	TV ;
isumannaallisaa	IV ;
isumannaap	XItsXmorf ;
isumannaarfig	TVschwa ;
isumannaargig	TVschwa ;
isumannaari	IV ;
isumannaarsar	TV ;
isumannaarsor	IV ;
isumannaarsor	TV ;
isumannaarsui	IV ;
isumannaar	TV ;
isumapilup	IV ;
isumaqaraluar	IV ;
isumaqarpallaar	IV ;
isumaqartip	TV ;
isumaqartitsi	IV ;
isumaqatigiikkunnaar	XIiXmorf ;
isumaqatigiiler	XIPXmorf ;
isumaqatigiinngissutig	TVschwa ;
isumaqatigiip	XIPXmorf ;
isumaqatigiissitsi	IV ;
isumaqatigiissoqeqarfig	TVschwa ;
isumaqatigiissoqig	TVschwa ;
isumaqatig	TVschwa ;
isumaqatissarsior	IV ;
isumarujup	IV ;
isumasi	IV ;
isumasior	TV ;
isumasi	TV ;
isumasiui	IV ;
isumassarseriallaqqip	XIiXmorf ;
isumassarseriataallaqqip	XIiXmorf ;
isumassarseriataar	IV ;
isumassarsiar	TVschwa ;
isumassarsi	IV ;
isumassarsiorfig	TVschwa ;
isumassarsior	IV ;
isumassarsisitaa	IV ;
isumassarsiui	IV ;
isumassor	TV ;
isumassui	IV ;
isumassaa	IV ;
isumassaarup	IV ;
isumassaavallaar	IV ;
isumatoorsuu	IV ;
isumatsangaartip	TV ;
isumatsap	IV ;
isumatsiar	IV ;
isumatu	IV ;
isumatusaarallar	IV ;
isumatusaar	IV ;
isumatusaarneru	IV ;
isumataar	IV ;
isumataartip	TV ;
isummakkunnaar	XIiXmorf ;
isummap	TV ;
isummeqatigiip	XIPXmorf ;
isummeqatig	TVschwa ;
isummer	IV ;
isummersor	TV ;
isummersui	IV ;
isummersuisuu	IV ;
isummer	TV ;
isummer	XTiXmorf ;
isumaakkunnaar	XIiXmorf ;
isumaallior	IV ;
isumaalug	TVschwa ;
isumaalukkajup	IV ;
isumaalunnar	IV ;
isumaalup	IV ;
isumaaluppallaar	IV ;
isumaap	XItsXmorf ;
isumaarukkiartor	IV ;
isumaarup	IV ;
isumaarussinnaa	IV ;
isumaatsoor	IV ;
isumaatsulior	IV ;
isunnga	IV ;
isunngalluar	IV ;
isunngar	IV ;
isunngaannar	IV ;
isusissaa	IV ;
isusi	TV ;
isussor	IV ;
isussor	TV ;
isussualup	IV ;
isussukulup	IV ;
isussukuluup	IV ;
isussup	IV ;
isussuup	XTuteXmorf ;
isussuussi	IV ;
isussuutig	TVschwa ;
isutseri	IV ;
isutser	XTiXmorf ;
isaa	IV ;
isaajar	IV ;
isaajar	TV ;
isaajaap	TV ;
isaap	TV ;
isaap	XItsXmorf ;
isaariakip	XItsXmorf ;
isaariartaar	IV ;
isaar	IV ;
isaartip	IV ;
isaar	TV ;
isaasorsuu	XIPXmorf ;
isaassi	IV ;
isaassivig	TVschwa ;
isaasuki	IV ;
isaasukilli	IV ;
isaasukip	XItsXmorf ;
isaatip	TV ;
isaatitsi	IV ;
italap	IV ;
italap	TV ;
iteerulluinnar	IV ;
iteerup	XIuteXmorf ;
iteerutivip	XIiXmorf ;
iteer	XTiXmorf ;
iteqqii	IV ;
iteqqili	TV ;
iteqqip	XIiXmorf ;
iteqqisip	TV ;
iteqqisaar	IV ;
iteqqaanni	IV ;
iteqqaanniup	IV ;
iteqqaarluusior	IV ;
iteqqaaser	IV ;
iteqqaaser	XTiXmorf ;
iteriallu	IV ;
iteriar	IV ;
iter	IV ;
iterluar	IV ;
iternerlup	IV ;
iteror	IV ;
iterornip	XItsXmorf ;
iterorsunni	IV ;
iterorsunnip	XItsXmorf ;
iterortitsi	IV ;
itersalior	IV ;
itersalior	TV ;
itersar	TV ;
itersaruar	IV ;
iterser	IV ;
itersersor	TV ;
iterser	TV ;
itersi	IV ;
itersi	TV ;
itersor	IV ;
itersaa	IV ;
itertip	TV ;
iteruinnarsuu	IV ;
itia	IV ;
itigar	IV ;
itigartip	TV ;
itigartitsi	IV ;
itigartitaa	IV ;
itigar	TV ;
iti	IV ;
itikkajaa	IV ;
itikkakuu	IV ;
itikkanga	IV ;
itikkap	TV ;
itikkaa	IV ;
itilligup	IV ;
itilli	IV ;
itillikkajup	IV ;
itillimukar	IV ;
itillinga	IV ;
itillinganar	IV ;
itillingaasar	IV ;
itilliorup	IV ;
itillip	IV ;
itillisip	TV ;
itinersior	IV ;
itinneraar	IV ;
itinngug	TVschwa ;
itinngu	IV ;
itinngunar	IV ;
itinnguup	TV ;
itinnip	IV ;
itip	TV ;
itisi	IV ;
itisileri	IV ;
itisiorup	IV ;
itisisip	TV ;
itisi	TV ;
itisoorsuu	IV ;
itissusersior	IV ;
itissusersior	TV ;
itivip	XIiXmorf ;
itiaallu	IV ;
itiaar	IV ;
itoqqip	XIiXmorf ;
itoqqisip	TV ;
itsali	IV ;
itsanngor	IV ;
itsarnisanngor	IV ;
itsarnisarpaluttunngortitsi	IV ;
itsarnisarsuu	IV ;
itsarnisaa	IV ;
itsarpalaar	IV ;
itsartoor	IV ;
itsianger	IV ;
itsi	IV ;
itsinar	IV ;
itsinertuallaar	IV ;
itsinertu	IV ;
itsinikip	XItsXmorf ;
itsior	TV ;
itsiup	XIuteXmorf ;
itsiutiinnar	XIPXmorf ;
itsiuup	XIPXmorf ;
itsiaarsaap	TV ;
itsiaarsaassi	IV ;
itsor	IV ;
itsor	TV ;
itsuannisaar	IV ;
itsuannisaar	TV ;
itsuar	IV ;
itsuartor	IV ;
itsuartor	TV ;
itsuar	TV ;
itsaar	IV ;
ittanneru	IV ;
ittanneruser	IV ;
ittap	IV ;
ittassar	IV ;
ittoor	IV ;
ittoornar	IV ;
ittoornarpallaar	IV ;
ittoornaap	XItsXmorf ;
ittoorpallaar	IV ;
ittoor	TVschwa ;
ittoorunnaar	IV ;
ittoorutigig	TVschwa ;
ittoorutig	TVschwa ;
ittoqer	IV ;
ittoqersuu	IV ;
Ittoqqortoormiinukar	IV ;
ittortaa	IV ;
ittuar	IV ;
ittuarsinnar	IV ;
ittuinnar	IV ;
ittujaari	IV ;
ittujaarsar	TV ;
ittujaarsaa	IV ;
ittujaarsaap	TV ;
ittujaarsaassi	IV ;
ittujaar	TV ;
ittulaar	IV ;
ittulaartorsuu	IV ;
ittup	IV ;
ittuppalup	IV ;
ittutsitsi	IV ;
ittuujuer	IV ;
ittuujuilli	IV ;
ittuujuillisaar	IV ;
ittuujuip	XItsXmorf ;
ittuujummer	IV ;
ittuukulup	IV ;
ittuutu	IV ;
Ittaajimmiinukar	IV ;
ituip	IV ;
ituip	TV ;
itullikkajup	IV ;
itullip	IV ;
itullisip	TV ;
itumammip	IV ;
itumammip	TV ;
itummiarer	TV ;
itummiar	IV ;
itummiar	TV ;
itummiup	TV ;
itussar	IV ;
itussar	TV ;
itussor	IV ;
itussup	TV ;
itussuup	TV ;
iuujoortor	TV ;
ivagajup	IV ;
iva	IV ;
ivaler	IV ;
ivaler	XTiXmorf ;
ivalluar	IV ;
ivalluar	TV ;
ivammaffaarip	XIiXmorf ;
ivammaguup	XIPXmorf ;
ivammap	IV ;
ivammattuinnaa	IV ;
ivaneerup	IV ;
ivanippallaar	IV ;
ivanip	XItsXmorf ;
ivanni	IV ;
ivator	IV ;
ivattor	IV ;
iva	TV ;
iver	IV ;
iversarner	IV ;
iverteqqip	TV ;
ivertip	IV ;
ivertip	TV ;
ivertissor	TV ;
ivertiteri	IV ;
ivertitsi	IV ;
ivertitaa	IV ;
ivertuusaar	IV ;
iveruser	IV ;
iverutaarser	IV ;
iver	XTiXmorf ;
iviangeersip	IV ;
iviangerlup	IV ;
iviangersior	TV ;
iviangiusalertip	IV ;
ivigarip	XIiXmorf ;
ivigar	IV ;
ivigartariar	IV ;
ivigartor	IV ;
ivikkarip	XIiXmorf ;
ivikkeri	IV ;
ivikkiar	IV ;
ivikkiartaannar	IV ;
ivip	IV ;
ivissugaarip	XIiXmorf ;
ivisaarunip	IV ;
Ivittuunukar	IV ;
ivu	IV ;
ivaaller	XIiXmorf ;
ivaar	TVschwa ;
iaaminar	IV ;
iaarnar	IV ;
ærkebiskoppiu	IV ;
aaffanniar	IV ;
aaffanniartip	IV ;
aaffanniusior	IV ;
aaffanniutaa	IV ;
aaffanniutaarup	IV ;
aaffap	IV ;
aagasap	IV ;
aagasattuinnaa	IV ;
aagasaar	IV ;
aagialip	IV ;
aagiap	IV ;
aaginnar	IV ;
aaginnaa	IV ;
aagiaannaa	IV ;
aagup	IV ;
aagup	TV ;
aagussaa	IV ;
aa	IV ;﻿aggeqqu	TV ;
aajup	IV ;
aajusalersor	TV ;
aajusaler	XIiXmorf ;
aajutig	TVschwa ;
aakajaarsuu	IV ;
aakassaar	IV ;
aakillior	IV ;
aakip	XItsXmorf ;
aakkajup	IV ;
aakkar	IV ;
aakkarnerasaar	IV ;
aakkarnerinnanngor	IV ;
aakkunnaar	IV ;
aakullersaa	IV ;
aalaguser	XIiXmorf ;
aala	IV ;
aalaja	IV ;
aalajanger	IV ;
aalajangerneqanngikkallar	IV ;
aalajangerneqanngikkaluar	IV ;
aalajangersarneqareer	IV ;
aalajangersar	TV ;
aalajangersimalluinnar	IV ;
aalajangersaa	IV ;
aalajanger	TV ;
aalajanger	XIiXmorf ;
aalajanger	XTiXmorf ;
aalajangiiniar	IV ;
aalajangiiniartip	IV ;
aalajangiisartuu	IV ;
aalajangiup	XTuteXmorf ;
aalajangiussiinnar	IV ;
aalajangiussi	IV ;
aalajangiutereer	XTiXmorf ;
aalajangiuteriigaa	IV ;
aalajartor	IV ;
aalajataar	IV ;
aalajuar	IV ;
aalajuartuu	IV ;
aalajaaffiginnip	IV ;
aalajaaffig	TVschwa ;
aalajaalli	IV ;
aalajaalluinnar	IV ;
aalajaap	XItsXmorf ;
aalajaatsorsuu	IV ;
aalajaatsuu	IV ;
aalakkap	XIPXmorf ;
aalakkattorsuu	XIPXmorf ;
aalakoorajup	IV ;
aalakoorajuppallaar	IV ;
aalakooraluar	IV ;
aalakoor	IV ;
aalakoortorujussuu	IV ;
aalakoorujussuar	IV ;
aalakuujaap	XItsXmorf ;
aalakuujaatsuu	IV ;
aalakuunni	IV ;
aalakuussalaar	IV ;
aalaler	XIiXmorf ;
aalanerrarip	XIiXmorf ;
aalangeer	IV ;
aalangeer	TV ;
aalanguser	IV ;
aalanguserunnaar	IV ;
aalaniar	IV ;
aalaniartarniar	IV ;
aalaniataar	IV ;
aalaniup	TV ;
aalaniussi	IV ;
aalanngivip	XIiXmorf ;
aalanngor	IV ;
aalap	TV ;
aalaqqajup	IV ;
aalaqqataar	IV ;
aalarianngitsoor	IV ;
aalariar	IV ;
aalariassanngilluinnar	IV ;
aalarsunnip	XItsXmorf ;
aalasar	IV ;
aalasinanngivip	XIiXmorf ;
aalasinar	IV ;
aalasinnanngivip	XIiXmorf ;
aalasinnaa	IV ;
aalasinnaanngivip	XIiXmorf ;
aalasinnaarpiar	IV ;
aalassap	IV ;
aalassariip	XItsXmorf ;
aalassarip	IV ;
aalassarip	XIiXmorf ;
aalassarissi	IV ;
aalassarissivip	XIiXmorf ;
aalassarissuu	IV ;
aalassarissaar	IV ;
aalassarlup	IV ;
aalassarlussi	IV ;
aalassaatig	TVschwa ;
aalateri	IV ;
aalateriniar	IV ;
aalaterneqangaar	IV ;
aalaterneqaatig	TVschwa ;
aalater	TV ;
aalaterusior	IV ;
aalaterutig	TVschwa ;
aalaterutaarup	IV ;
aalatipiloor	TV ;
aalatippallaar	TV ;
aalatip	TV ;
aalatseriip	XItsXmorf ;
aalatsi	IV ;
aalatsisar	IV ;
aalataar	IV ;
aalavap	IV ;
aalersor	IV ;
aalersor	TV ;
aaler	TV ;
aalisaganip	IV ;
aalisagarpassuaqarallar	IV ;
aalisagarpassuaqaraluaraluni	K ;﻿ajakkip	XItsXmorf ;
aalisagarpassuaqaraluar	IV ;
aalisagaalatsi	IV ;
aalisagaarniar	IV ;
aalisagaarup	IV ;
aalisakkeri	IV ;
aalisakkerisar	IV ;
aalisakkerisuu	IV ;
aalisakker	IV ;
aalisakkeriveqaraluar	IV ;
aalisakkeriveqartuugaluar	IV ;
aalisakkeriveqartuu	IV ;
aalisaler	TV ;
aalisaler	XIiXmorf ;
aalisarajup	IV ;
aalisarfigigaluar	TV ;
aalisarfig	TVschwa ;
aalisariar	IV ;
aalisariutig	TVschwa ;
aalisar	IV ;
aalisarrap	IV ;
aalisarrattorsuu	XIPXmorf ;
aalisarsinnaatitaa	IV ;
aalisartorpassuugaluar	XIPXmorf ;
aalisartorpassuu	XIPXmorf ;
aalisartorpaalussuu	XIPXmorf ;
aalisartuu	IV ;
aalisar	TV ;
aalisassaar	IV ;
aalisaannar	IV ;
aalisaatig	TVschwa ;
aalisaataarser	IV ;
aalisaataarup	IV ;
aalitsap	IV ;
aalitsersor	TV ;
aalitsersui	IV ;
aalitsersuisar	IV ;
aalitser	TV ;
aalitsiup	XTuteXmorf ;
aallaja	IV ;
aallajaallu	IV ;
aallakaa	IV ;
aallakaateqqip	TV ;
aallakaateqqitassaa	IV ;
aallakaateqqitaa	IV ;
aallakaateriigaa	IV ;
aallakaatip	TV ;
aallakaatitassioriartor	IV ;
aallakaatitassior	IV ;
aallakaatitsi	IV ;
aallakaatitsisar	IV ;
aallalersaaraluar	IV ;
aallalersaar	IV ;
aallaler	XIiXmorf ;
aallanngisaannar	IV ;
aallanngitsoor	IV ;
aallaqqusi	IV ;
aallaqqu	TV ;
aallaqqaanniup	IV ;
aallaqqaar	IV ;
aallaqqaasior	TV ;
aallaqqaasiup	XTuteXmorf ;
aallaqqaasiutig	TVschwa ;
aallarar	XIPXmorf ;
aallarataar	IV ;
aallariarfittu	IV ;
aallariarfittusi	IV ;
aallar	IV ;
aallarnaveer	IV ;
aallarnaveersaar	IV ;
aallarnersar	TV ;
aallarnersaatig	TVschwa ;
aallarnertu	IV ;
aallarner	XIiXmorf ;
aallarner	XTiXmorf ;
aallarnii	IV ;
aallarniinnar	IV ;
aallarniinnar	TV ;
aallarniisuu	IV ;
aallarniivig	TVschwa ;
aallarniutig	TVschwa ;
aallarniutaa	IV ;
aallarsar	IV ;
aallarsartip	TV ;
aallarsimaar	IV ;
aallarsinnaa	IV ;
aallarsinnaanngivip	XIiXmorf ;
aallarsor	TVschwa ;
aallarter	IV ;
aallartip	IV ;
aallartip	TV ;
aallartitsi	IV ;
aallartitaa	IV ;
aallartoorfig	TVschwa ;
aallartoor	IV ;
aallar	TV ;
aallartaali	TV ;
aallartaannar	IV ;
aallarup	XTuteXmorf ;
aallarussi	IV ;
aallarussaa	IV ;
aallarusukkaluar	IV ;
aallarusunnar	IV ;
aallarusup	IV ;
aallasatsap	IV ;
aallavikip	XItsXmorf ;
aallersip	TV ;
aallersitsi	IV ;
aallersoor	IV ;
aallersug	TVschwa ;
aaller	XIiXmorf ;
aalliorup	IV ;
aalliup	TV ;
aalliussi	IV ;
aallulluar	TV ;
aallup	XTuteXmorf ;
aallussi	IV ;
aallutarilluar	TV ;
aallutar	TVschwa ;
aallutivip	TV ;
aallaagaluar	TV ;
aallaa	IV ;
aallaallior	IV ;
aallaama	IV ;
aallaanerlup	TV ;
aallaaniar	IV ;
aallaaniarlutip	IV ;
aallaaniartip	IV ;
aallaannar	IV ;
aallaariallaqqip	XIiXmorf ;
aallaariallaqqissi	IV ;
aallaariallaqqissivip	XIiXmorf ;
aallaariallaqqivip	XIiXmorf ;
aallaariar	IV ;
aallaariar	TV ;
aallaar	IV ;
aallaarrap	IV ;
aallaarsar	TVschwa ;
aallaarsimarrap	IV ;
aallaarsimaar	IV ;
aallaarsimaarrap	IV ;
aallaarsimaartaannar	IV ;
aallaarsuup	TV ;
aallaartaannar	IV ;
aallaaseeqqior	IV ;
aallaaserar	IV ;
aallaasersor	IV ;
aallaasersullaqqip	XIiXmorf ;
aallaasig	TVschwa ;
aallaasitaar	IV ;
aallaasitaartip	TV ;
aallaasaajar	IV ;
aallaasaar	IV ;
aallaasaarserajup	IV ;
aallaasaarser	IV ;
aallaasaar	TV ;
aallaatip	TV ;
aallaa	TV ;
aallaavig	TVschwa ;
aalaakkeqqinnaar	TV ;
aalaakker	XTiXmorf ;
aalaakkip	XItsXmorf ;
aalaakkivip	XIiXmorf ;
aalaakkivip	XTiXmorf ;
aalaakkaa	IV ;
aalaallapiar	IV ;
aalaallap	IV ;
aalaallariar	IV ;
aalaallatsip	TV ;
aalaaluup	XIutePXmorf ;
aalaaluutiinnar	XIPXmorf ;
aalaaluuttuinnaa	XIPXmorf ;
aalaavataar	IV ;
aama	IV ;
aamakilli	IV ;
aamakip	XItsXmorf ;
aamalior	IV ;
aamali	TV ;
aamarsuaasor	IV ;
aamingaar	IV ;
aamingaarpallaar	IV ;
aamip	TV ;
aammaloor	IV ;
aammeer	IV ;
aammer	IV ;
aammersimaar	IV ;
aammingaar	IV ;
aammisersor	TV ;
aammisersui	IV ;
aammiup	IV ;
aammaaqqip	XIiXmorf ;
aammaar	IV ;
aamaajaataarser	IV ;
aamaannaa	IV ;
aamaar	IV ;
aamaarnikilli	IV ;
aamaarnikip	XItsXmorf ;
aamaartip	TV ;
aamaarulluinnar	IV ;
aamaarunnaar	XIiXmorf ;
aamaarup	IV ;
aamaarutiaar	IV ;
aamaasior	IV ;
aamaasaa	IV ;
aanaqqiutig	TVschwa ;
aanaveersar	TV ;
aanaveersaa	IV ;
aanaveersaasar	IV ;
aanaveersaasartuu	IV ;
aaneqatap	TV ;
aanga	IV ;
aanikuuallaar	IV ;
aanikuu	IV ;
aaninga	IV ;
aaningajaa	IV ;
aannerseraar	IV ;
aannersaar	TV ;
aannertu	IV ;
aannertusaari	IV ;
aannertusaar	TV ;
aannga	IV ;
aanngajup	IV ;
aanngar	IV ;
aanngar	TV ;
aanngasip	XIiXmorf ;
aanngu	IV ;
aanngaa	IV ;
aanngaalli	IV ;
aanngaallivip	XIiXmorf ;
aanngaalaarallar	IV ;
aanngaalaar	IV ;
aanngaalaarniar	IV ;
aanngaama	IV ;
aanngaama	TV ;
aanngaap	XItsXmorf ;
aanngaa	TV ;
aanngaavip	TV ;
aannikip	XItsXmorf ;
aanaalersor	TV ;
aanaar	IV ;
aanaarnaveersaatig	TVschwa ;
aanaartitsi	IV ;
aanaartoor	IV ;
aanaarunnaar	XIiXmorf ;
aapa	IV ;
aapakor	IV ;
aapakortitsi	IV ;
aapakortitsiniar	IV ;
aapakaa	IV ;
aapakaaju	IV ;
aapakaajusaar	IV ;
aapakaanga	IV ;
aapakaassi	IV ;
aapasortor	IV ;
aappakattar	TVschwa ;
aappalajap	IV ;
aappalajaar	IV ;
aappalisaatig	TVschwa ;
aappaliu	IV ;
aappallarip	XIiXmorf ;
aappallarissi	IV ;
aappalloquser	IV ;
aappalloquser	TV ;
aappalloqutaa	IV ;
aappalualaar	IV ;
aappaluar	IV ;
aappalujap	IV ;
aappalukujup	IV ;
aappalunguser	IV ;
aappalup	IV ;
aappalussi	IV ;
aappaluttunngor	IV ;
aappaluttunngortsip	TV ;
aappaluttunngor	TV ;
aappalaartulersor	IV ;
aappalaartuler	XIiXmorf ;
aappalaartuliup	TV ;
aappanip	IV ;
aappannaar	TVschwa ;
aappaqanngitsuu	IV ;
aappariiler	XIPXmorf ;
aappariip	XIPXmorf ;
aapparitsiar	TV ;
aappar	IV ;
aapparser	TV ;
aapparser	TVschwa ;
aapparsiarser	TV ;
aappar	TVschwa ;
aappasseri	IV ;
aappassiariip	XIPXmorf ;
aappassiar	TVschwa ;
aappassaaneer	IV ;
aappassaaneer	TV ;
aappeer	IV ;
aapper	XTiXmorf ;
aappii	IV ;
aappila	IV ;
aappilajaar	IV ;
aappilattuliar	IV ;
aappilattumukar	IV ;
aappilattutor	IV ;
aappillap	IV ;
aappillarip	XIiXmorf ;
aappillarissi	IV ;
aappiller	IV ;
aappillersar	TV ;
aappillersaatig	TVschwa ;
aappiller	XIiXmorf ;
aappisar	IV ;
aappiup	XIuteXmorf ;﻿aggiup	XTuteXmorf ;
aappiup	XTuteXmorf ;
aappiussi	IV ;
aappaarser	IV ;
aap	TV ;
aap	XItsXmorf ;
aapaalingiag	TVschwa ;
aapaalingiap	IV ;
aapaar	IV ;
aapaartortor	IV ;
aapaartutor	IV ;
aapaartutorniar	IV ;
aaqartalereer	IV ;
aaqartaler	IV ;
aaqartaler	XIiXmorf ;
aaqqasi	IV ;
aaqqasiup	TV ;
aaqqatigip	XIiXmorf ;
aaqqatigissaar	IV ;
aaqqataarser	IV ;
aaqqataarup	IV ;
aaqqiagiikkunnaar	IV ;
aaqqiagiikkunnaar	XIPXmorf ;
aaqqiagiip	XIPXmorf ;﻿ajuup	XIuteXmorf ;
aaqqiag	TVschwa ;
aaqqigup	XTuteXmorf ;
aaqqiissutiginiar	TV ;
aaqqiissutig	TVschwa ;
aaqqiissutaa	IV ;
aaqqip	IV ;
aaqqip	TV ;
aaqqisimaar	IV ;
aaqqissor	TV ;
aaqqissui	IV ;
aaqqissuisar	IV ;
aaqqissuisuu	IV ;
aaqqissuup	XTuteXmorf ;﻿affarler	TVschwa ;
aaqqissuusseqqip	XTiXmorf ;
aaqqissuussi	IV ;
aaqqissuussilluar	IV ;
aaqqissuussisuu	IV ;
aaqqissuussisuuneru	IV ;
aaqqitassaa	IV ;
aaqqitaa	IV ;
aaqqiup	TV ;
aarartaar	IV ;
aariammip	TV ;
aar	IV ;
aarleqqup	TV ;
aarleqqussi	IV ;
aarleqqutigisariaqanngivip	XIiXmorf ;
aarleqqutig	IVschwa ;
aarleqqutig	TVschwa ;
aarlerigaluar	IV ;
aarlerig	TVschwa ;
aarleriilluinnar	IV ;
aarleriippallaar	IV ;
aarleriip	XItsXmorf ;
aarleriisaar	IV ;
aarleri	IV ;
aarleriler	XIiXmorf ;
aarlerinakujukkaluar	IV ;
aarlerinakujup	IV ;
aarlerinar	IV ;
aarlerisaaraluar	TV ;
aarlerisaar	TV ;
aarlerisaarutigineqaraluar	IV ;
aarlerisaarutig	TVschwa ;
aarleritsap	IV ;
aarleritsavip	XIiXmorf ;
aarleritsaap	TV ;
aarleritsaassi	IV ;
aarler	IVschwa ;﻿affarleriip	XIPXmorf ;
aarler	TVschwa ;
aarliup	IV ;
aarlorikkuu	IV ;
aarlor	IV ;
aarlortip	TV ;
aarlorup	TV ;
aarlorussi	IV ;
aarlorutiinnar	TV ;
aarluarsup	IV ;
aarlukkajup	IV ;
aarlunga	IV ;
aarlungaar	IV ;
aarlungaartip	TV ;
aarlunnar	IV ;
aarlup	TV ;
aarmeer	IV ;
aarnertu	IV ;
aarngusser	IV ;
aarngusser	TV ;
aarniar	IV ;
aarniar	TV ;
aarnikip	XItsXmorf ;
aarnuartaar	IV ;
aarnuartaar	TVschwa ;
aarnusser	IV ;
aarnusser	XTiXmorf ;
aarnussi	IV ;
aarnussior	IV ;
aarsiinnar	IV ;
aarsaaqattaar	IV ;
aarsaaqattaartip	TV ;
aarsaarfig	TVschwa ;
aarsaar	IV ;
aarsaarnialersar	IV ;
aarsaarusior	IV ;
aarsaarutitaar	IV ;
aar	TV ;
aasakip	XItsXmorf ;
aasali	IV ;
aasaraluttuinnar	IV ;
aasarip	XIiXmorf ;
aasarissi	IV ;
aasarissivip	XIiXmorf ;
aasarissaar	IV ;
aasar	IV ;
aasarsior	IV ;
aasarsiortarfig	TVschwa ;
aasarsiortarfiutig	TVschwa ;
aasarsiortip	IV ;
Aasianninngaanneer	IV ;
Aasiannukar	IV ;
aasi	IV ;
aasimavallaar	IV ;
aasinga	IV ;
aasingavallaar	IV ;
aasip	TV ;
aasivimmukar	IV ;
aasivissior	IV ;
aasivissip	IV ;
aasoor	IV ;
aasser	TV ;
aassinga	IV ;
aassuap	IV ;
aassuatsip	IV ;
aassup	IV ;
aassusser	TV ;
aassutsip	IV ;
aasunnip	XItsXmorf ;﻿a'ar	IV ;
aasup	IV ;
aasusser	TV ;
aasussor	TV ;
aasutser	TV ;
aasutsip	IV ;
aasaa	IV ;
aatag	TVschwa ;
aatalisar	IV ;
aataqqeer	TVschwa ;
aateri	IV ;
aaterisar	IV ;
aaterisuu	IV ;
aatip	IV ;
aatip	TV ;
aatoror	IV ;
aatsanga	IV ;
aatsar	IV ;
aatsartip	TV ;
aatsassanngap	TV ;
aatsassanngassi	IV ;
aatseri	IV ;
aatsersorsuu	IV ;
aatser	XIiXmorf ;
aatser	XTiXmorf ;
aatsialaa	IV ;
aatsi	IV ;
aatsiler	XTiXmorf ;
aatsiortor	IV ;
aatsip	IV ;
aatsip	TV ;
aatsisar	IV ;
aatsisartuu	IV ;
aatsitalior	IV ;
aatsitaliorniar	IV ;
aatsitassaqarfiu	IV ;
aatsitassarsior	IV ;
aatsitsi	IV ;
aatsitsisar	IV ;
aatsiumagaluar	IV ;
aatsiuma	IV ;
aatsivig	TVschwa ;
aatsornar	IV ;
aatsornartorsuu	IV ;
aatsorneqarsinnaa	IV ;
aatsorsi	IV ;
aatsorsui	IV ;
aatsorsaar	TV ;
aatsor	TV ;
aatsui	IV ;
aatsuler	XIiXmorf ;
aatsuukkiartor	IV ;
aatsuup	IV ;
aatsaaginnannguu	IV ;
aatsaanga	IV ;
aatsaangaar	IV ;
aatsaannguu	IV ;
aatsaar	IV ;
aatsaar	TV ;
aattarip	XIiXmorf ;
aattor	IV ;
aattor	TV ;
aattui	IV ;
aattuinnaa	IV ;
aattuler	XIiXmorf ;
﻿ajattaap	XIutePXmorf ;
aattuutig	TVschwa ;
aattuutaarser	IV ;
aa	TV ;
﻿isumaqatigiinngiler	XIiPXmorf ;
﻿akunnip		XItX ;
aataanip	IV ;
aataarsuar	IV ;
aataasi	IV ;
aataavarar	IV ;
aataaverup	IV ;
aataavilatsi	IV ;
aataavisap	IV ;
aavalersaaraluar	IV ;
aavalersaar	IV ;
aavarajup	IV ;
aavaraluar	IV ;
aavariar	IV ;
aavariartaraluar	IV ;
aavar	IV ;
aavarnilersaar	IV ;
aaver	IV ;
aaverluer	IV ;
aaverniar	IV ;
aaversip	IV ;
aaversittartussarsior	IV ;
aaversittartuu	IV ;
aaver	TV ;
aaverup	IV ;
aaver	XTiXmorf ;
agissarip	XIiXmorf ;
aavialip	IV ;
aaviap	IV ;
aaviar	IV ;
aaviar	TV ;
aavii	IV ;
aaviisor	IV ;
aavilersor	TV ;
aavilersui	IV ;
aavingajap	IV ;
aavinnarsuu	IV ;
aavinnaa	IV ;
aaviaa	IV ;
aavoor	IV ;
aavoorniar	IV ;
aavoorpalup	IV ;
aavoortor	IV ;
